Configuracion Inicial|Hasierako konfigurazioa
Seleccione el Idioma / Select the Language|Hautatu hizkuntza / hautatu hizkuntza
Color|color
Movimiento|motion
Otros|beste batzuk
Indiquenos desde que sitio ha descargado este programa|Esan programa honetatik deskargatu duzun gunetik
Correo Electronico|posta elektronikoa
2 decimales|2 hamartar
0 decimales|0 hamartar
Seleccione el Numero de Decimales|Hautatu hamartarren kopurua
Seleccione el Impuesto|Aukeratu Zerga
Seleccione su Bandera|Aukeratu zure bandera
Seleccione la Moneda|Aukeratu Moneta
Seleccione el Pais|Aukeratu herrialdea
Nombre de Empresa|Enpresaren izena
Continuar|jarraitu
Programa|programa
Continuar / Continue|Jarraitu / Jarraitu
Este boton le permitira cambiar la configuracion regional|Botoi honek eskualdeko ezarpenak aldatzen uzten dizu
Con este boton cambiara el tamaño de la ventana.|Botoi honekin, leihoaren tamaina aldatuko duzu.
Con este boton podra ver datos de su licencia|Botoi honekin zure lizentzia datuak ikus ditzakezu
Este boton le servira para cambiar el idioma|Botoi honek hizkuntza aldatzeko balio du
Con este boton cambiara el color de la pantalla|Botoi honekin pantailaren kolorea aldatu egingo da
Programa protegido por los derechos de propiedad intelectual en Marcas y Patentes en cuanto a contenido y diseño.|Marka eta Patenteen jabetza intelektualeko eskubideak babestutako programa edukiak eta diseinua kontuan hartuta.
Madrid - España|Madril - Espainia
Tpv|TPV
** Bienvenido **|** Ongi **
Salir|irteera
Caja Entradas|Sarreren koadroa
Seleccione Su Opcion|Aukeratu zure aukera
Caja Ropero|Wardrobe Box
Comprar|erosi
¡Tiempo Limitado!|Denbora mugatua!
6 Comprados|6 Erosi
Horas:|ordutegia:
Cod Promocion: XXXXX|Bakailaoaren sustapena: XXXXX
Tiene un descuento de|Deskontua du
Precios|prezioak
* Recuerde que para poder tener asistencia telefonica tiene que tener contratado la version Completa, en caso contrario haga su consulta directamente desde el programa.|* Gogoratu telefonia laguntza izateko bertsio osoa izan behar duzula, bestela programatik zuzenean kontsultatu.
* Consulte nuestra pagina web, para confirmar los precios que es posible que hayan sufrido algun cambio|* Kontsultatu gure webgunea, aldaketa batzuk jasan dituzten prezioak baieztatzeko
<Tipo de Licencia>|<Lizentzi mota>
Estoy utilizando una licencia|Lizentzia bat erabiltzen ari naiz
Diferencias entre tipos de licencia|Lizentzia mota guztien arteko desberdintasunak
Pasar de la version Gratuita a la Basica|Aldatu doako eta oinarrizko bertsio batetik
Promociones / Envio Email|Promozioak / Posta elektronikoa
Admisitracion Permisos|Onarpen baimenak
Tipos de licencia|Lizentzia motak
Conectar en Red|Sarera konektatzea
Activar Gratis la version Basica|Aktibatu Oinarrizko bertsioa doan
Registrar|erregistro
<Terminal>|<Terminal>
Acerca de|buruz
Asistencia|laguntza
Configuracion|configuración
Listados|zerrendak
Caja|box
Conexion con dispositivo movil - android|Gailu mugikorrarekin konexioa - android
Niveles de Acceso|Sarbide-maila
Almacenes|biltegiak
Mantenimiento|mantentze
Actualizaciones Activadas|Aktibatu eguneraketak
Tpv 123 Hosteleria (Version: 8.5.1)|Tpv 123 Hosteleria (bertsioa: 8.5.1)
Serie: XXX|Seriea: XXX
Licencia: XXX|Lizentzia: XXX
PROGRAMA REGISTRADO|PROGRAMA ERREGISTRATUTA
nombre restaurante|jatetxe izena
Tpv 123 Hosteleria|Tpv 123 Ostalaritza
ADVERTENCIAS IMPORTANTES|ADIERAZPEN GARRANTZITSUAK
- El desconocimiento de estas condiciones no le exime del cumplimiento de las mismas.|- Baldintza hauen ezjakintasuna ez da haiekin betetzea.
- Solo los clientes con la version COMPLETA tienen incluida la asistencia telefonica|- COMPLETE bertsioarekin bakarrik bezeroek telefono bidezko laguntza dute
---- En la modalidad COMPLETA, realizando un pago anual, ademas de las opciones incluidas en la version BASICA, tendra derecho a la asistencia de forma telefonica.|---- Modu osagarrian, urteko ordainketa egiten baduzu, OINARRIZKO bertsioan sartutako aukeren gain, telefono bidezko laguntza izango duzu.
---- En la modalidad BASICA, con una reducida cuota anual usted tendra habilitada las opciones del programa que le permitiran realizar todas gestiones necesarias para su negocio, para mayor detalle recuerde consultar la opcion de Tipos de Licencia.|---- BASIC moduan, urteko kuota murriztuarekin aukera emango dizu zure negoziorako beharrezko urratsak egiteko aukera ematen duen programa-aukera, xehetasun gehiago gogoan izan Lizentzia motak aukeratzerakoan.
Si decide utilizar la version GRATUITA recuerde que tiene algunas limitaciones, consulte la opcion de Tipos de Licencia para una descripcion mas detallada de la version GRATUITA, BASICA y COMPLETA.|DOAKO GRAFIKOA erabiltzea erabakitzen baduzu gogoan izan muga batzuk badituzu, ikusi Lizentzia motak aukera FREE, BASIC eta COMPLETE bertsioaren deskribapen zehatza lortzeko.
---- En la modalidad GRATUITA, durante los primeros 90 dias usted podra probar y trabajar con la version BASICA, pasado ese periodo podra volver a la version gratuita o pasar a la version BASICA o COMPLETA. Recuerde que esta version GRATUITA  es para empr|---- Doako moduan, lehen 90 egunetan BASIC bertsioarekin saiatu eta lan egin dezakezu, garai hartan bertsio askea itzultzeko edo BASIC edo COMPLETE bertsioara joateko. Gogoratu bertsio hau FREE dela enpresa
- La empresa Tpv 123 - Gratuito no es responsable si el cliente formatea el equipo o es atacado por algun tipo de virus que provoque la perdida de informacion o de licencia.|- Tpv 123 enpresak - Gratuito konpainiak ez du erantzukizunik bezeroak ekipamendua formateatzen badu edo informazio edo lizentzia galerak eragiten duen birus mota batek erasotzen badu.
- Tpv 123 - Gratuito recomienda la compra, para el buen funcionamiento del programa, de una impresora de tickets EPSON/SAMSUNG/Star o cualquier modelo de impresora, siempre que se instale junto con los drivers de dicha impresora. (Tipo de conexion recomen|- Tpv 123 - Free gomendatzen du EPSON / SAMSUNG / Star txartelaren inprimagailu baten edo inprimagailuaren modeloaren erosketa egiteko programa egokia funtzionatzeko, baldin eta inprimagailuaren kontrolatzaileekin batera instalatuta badaude. (Konexio mota berrikusi
- Este es un programa estandar, no se hacen modificaciones a medida o personalizaciones, nuestros clientes en version BASICA y COMPLETA si pueden sugerirnos algunos cambios que nosotros sin ningun coste añadido incluiremos en siguientes versiones.|- Programa estandarra da, aldaketak edo pertsonalizazio pertsonalizatuak ez dira egiten, gure bezeroek OINARRIZ eta EDUKI OSAGARRIAK bertsio hauek eskaintzen dituzten kostu gehigarririk gabeko aldaketa batzuk iradokitzen badituzte.
- Si usted esta utilizando la version GRATUITA y necesita algun tipo de asistencia recuerde que tiene que contratar la version BASICA o COMPLETA dependiendo de su incidencia.|- FREE bertsioa erabiltzen ari bazara eta laguntza behar baduzu, gogoratu BASIC edo COMPLETE bertsioa kontratatu behar duzula zure inportazioaren arabera.
Al instalar este programa,usted acepta las siguientes condiciones:|Programa hau instalatzean, honako baldintza hauek onartzen dituzu:
CONDICIONES DE USO DEL PROGRAMA|PROGRAMAREN ERABILERA BALDINTZAK
Promociones Fast Food|Elikadura azkarreko promozioak
Zonas|eremuetan
SubFamilias|azpifamilia
Productos Elaborados|Prozesatutako produktuak
Productos|ekoizteko
Familias|familiek
Varios Precios|Hainbat prezio
Formas de Pago|Ordainketa inprimakiak
Empleados|langileak
Clientes|bezeroei
Proveedores|hornitzaile
Aceptar|onartu
Cancelar|bertan behera
Eliminar|kendu
Modificar|aldaketaren
Nuevo|berriaren
No Movimiento|Mugimendua ez
Productos relacionados con el proveedor:|Hornitzailearekin lotutako produktuak:
Dia de Visita:|Bisitatu eguna:
Número de Cuenta:|Kontu zenbakia:
Nombre del Banco|Bankuaren izena
Dia de Pago:|Ordainketa Eguna:
Forma de Pago:|Ordainketa modua:
Observaciones:|behaketa:
Correo Electrónico:|E-mail:
Móvil / Celular:|Mugikorra / Zelularra:
Teléfono:|telefono:
Dirección:|helbidea:
Población:|populazio:
Código Postal:|Postal Kodea:
Provincia:|probintzia:
País:|herrialdea:
DNI / CIF|NAN / IFZ
Contacto:|jarri harremanetan:
Nombre|izen
Gestion de Proveedores|Hornitzaileen Kudeaketa
Lista de Proveedores|Hornitzaileen zerrenda
Ver Ingredientes|Ikusi osagaiak
Ver Productos Venta|Ikusi produktuak salmenta
Zona:|inguruan:
    Buscar Por Nombre:|    Bilatu izenaren arabera:
Codigoproducto|Kodeko produktua
Barra|bar
Cocina|sukaldea
Ambos|bai
situaciongrid|situaciongrid
Posicion  en Pantalla:|Pantailaren kokapena:
Ingredientes|osagai
Producto para Venta|Salmenta produktua
Mostrar en Pantalla de Caja:|Erakutsi kutxa pantailan:
Precio de Venta:|Salmenta prezioa:
Impuesto:|Zerga:
grid_ingredientes|grid_ingredientes
grid_productosventas|grid_productosventas
Descripcion Numerica:|Deskribapen numerikoa:
Seleccionar Color:|Hautatu kolorea:
Insertar Imagen|Txertatu irudia
Tipo de Producto:|Produktu mota:
Producto preparado en:|Prestatutako produktua:
Coste:|kostua:
Stock Actual:|Uneko Stock:
Stock Minimo:|Stock minimoa:
Proveedor:|hornitzaile:
Codigo de Barras:|Bar Kodea:
Unidades de medida:|Neurri unitateak:
Nombre del Producto:|Produktuen izena:
Gestion de Productos|Produktuen kudeaketa
Buscar|bilaketa
Resultados de la Busqueda|Bilaketa emaitzak
panel de busqueda de clientes|bezeroaren bilaketa panel
Buscar Clientes|Bilatu bezeroak
** DOBLE CLIC EN EL CLIENTE DESEADO|** DOAKO BIDALKETA BEZEROEN ESKUBIDEAK
Rellene algun campo para la busqueda|Bete bilaketa egiteko eremu batzuk
DNI/ CIF|NAN / IFZ
Tlf Movil|Telefono mugikorra
Telefono|telefonoz
Email|email
Provincia|probintzia
Poblacion|Población
Apellidos|abizenak
CP|CP
Codigo Cliente|Bezeroaren kodea
situacion|egoera
Descuento %|% deskontua
historico ventas|salmenta historikoak
datos|datuak
Lista Ultimos 50 Clientes|Azken 50 Bezeroen zerrenda
Puerta|atea
Numero|zenbakia
Piso|apartamentu
Direcccion|Zuzendaritza
Nombre *|Izena *
situacion buscar|egoera bilaketa
Gestion de Clientes|Bezeroaren kudeaketa
Familia Tipo Menu Combo|Familia motako menuaren konbinazioa
Familia Tipo Menu|Familia motako menua
Familia Generica|Familia generikoa
Gestion de Familias|Familia kudeaketa
Clic sobre la familia para ver mas detalles|Egin klik familiarekin xehetasun gehiago ikusteko
Lista de Familias|Familien zerrenda
*Pulse en la familia para ver los productos agregados a la misma|* Egin klik familiakoan gehitutako produktuak ikusteko
Seleccione el tipo de familia|Hautatu familia mota
Lb_stopanelproductos|Lb_stopanelproductos
Esta familia no tiene productos relacionados|Familia honek ez du zerikusia duen produkturik
lista productos|zerrendako produktuak
Clic en el producto que desee incluir en su familia|Egin klik zure familian sartu nahi duzun produktua
Lista de Productos |Produktuen zerrenda
Añadir Productos|Gehitu produktuak
Tipo de Familia:|Familia mota:
Label5|label5
datos generica|datu generikoak
datos familia generica|familiako datu generikoak
Imagen|irudi
Datos de la Familia|Familia Datuak
Mostrar en Caja |Erakutsi koadroan
Posicion en Pantalla|Pantailaren kokapena
Descripcion Numerica|Zenbakizko azalpena
Productos Incluidos|Produktu sartzen dira
panel menu familia|panel menu family
Producto incluido en otra familia|Beste familia batean sartutako produktua
Productos Tercer Plato/ Postre|Hirugarren platera / Postrea Produktuak
Productos Segundo Plato|Bigarren Plaka Produktuak
Productos Primer Plato|Lehen Plaka Produktuak
Añadir Postre|Gehitu postrea
Añadir Segundo|Gehitu bigarrena
Añadir Primero|Gehitu lehen
Impuesto|zerga
Precio de Venta|Salmenta prezioa
tipo|mota
NO BORRAR|Ez bota
situacion paneles|egoera-panelak
Añadir + Productos a la SubFamilia|Gehitu + Produktuak subfamiliara
Clic en el producto que desee incluir en el subproducto|Egin klik azpiko produktuetan sartu nahi duzun produktua
Familia a la que pertenece|Familia zein den
datos subfamilia|subfamilia datuak
Datos de la SubFamilia|Subfamilia datuak
SubFamilias Existentes|Azpi familiak
Num S.S.:|Num S.S .:
Repartidor:|askatzaile:
Apellidos:|Abizenak:
Color en Caja:|Kutxa kolorea:
Número de  Cuenta:|Kontu zenbakia:
Nombre  del Banco:|Bankuaren izena:
Foto:|Argazkia:
Correo  Electrónico:|E-mail:
NIF/ CIF:|NIF / IFZ:
Nombre:|Izena:
Lista de Empleados|Langileen zerrenda
Gestion de Empleados|Langileen kudeaketa
*clic para ver datos del producto|* Egin klik produktuaren datuak ikusteko
top grid|goiko sarea
Sirve para que en lugar de que  aparezca una imagen en el boton  del producto aparezca un numero.|Produktuaren botoiaren irudia agertzen ez den bitartean, zenbaki bat agertzen da.
alturacandidadingredientes|alturacandidadingredientes
Es el lugar donde queremos que se  muestre el producto en caja cuando hacemos clic sobre su familia.|Kaxa koadroan produktua erakutsi nahi dugun tokia da.
nombreproducto|ProductName
Codigo|kodea
CantidaddeIngredientes|Osagai kopurua
Cantidad|kantitate
Ingredientes Incluidos en el Producto: |Produktuan sartzen diren osagaiak:
Ver Datos Completos|Ikusi datu osoa
¿cuantos|Zenbat dira?
sto ingredientes|sto osagaiak
Producto Elaborado|Prozesatutako produktua
Producto preparado en|Prestatutako produktua
Descripcion  Numerica:|Deskribapen numerikoa:
situacion izquierda|ezkerreko egoera
situacion derecha|egoera zuzena
alturagrid|alturagrid
Seleccione el producto o el ingrediente a utilizar|Hautatu erabili beharreko produktua edo osagaiak
Ver Productos|Ikusi produktuak
Gestion de Productos Elaborados|Prozesatutako produktuen kudeaketa
Ver Ingredientes Incluidos|Ikusi osagaiak barne
Añadir Producto|Gehitu produktua
Nuevo Precio|Prezio berria
Precio Actual|Uneko prezioa
Añadir Nuevos Productos|Gehitu produktu berriak
Producto|Produktu
Precio Original|Jatorrizko prezioa
Precios Validos entre los siguientes dias y horas|Hurrengo egunetan eta orduetan prezio baliagarriak
Hora Hasta|Ordu arte
Hora Desde|Denbora aurrera
Fecha Hasta|Data arte
Fecha Desde|Data honetatik aurrera
Nombre de la lista|Zerrendaren izena
SITUACION DE LOS PANELES|PANELAKO EGOERA
Id lista|Id zerrenda
Fecha de Alta|Erregistroaren data
Desde|batetik
Hasta|ireki
Horario Desde|Ordutegia aurrera
Horario Hasta|Ordutegia Up
Ver Lista|Ikus zerrenda
Lista de Precios Existentes|Prezioen zerrenda
Volver Lista de Precios|Itzuli prezioa zerrendara
Lista de Precios|Prezio zerrenda
Productos de Barra|Barra produktuak
Productos de cocina|Sukaldeko produktuak
Esta zona la voy a utilizar para|Eremu hau erabiliko dut
Zonas Existentes|Eremu existitzen
Zonas de Impresion|Inpresio eremuak
Diseño|diseinua
Otro Terminal|Beste terminal
Reservada|erreserbatuta
Ocupada|lanpetuta
Libre|doan
Panel Mesas|Paneleko taulak
Mesas|taulak
Diseño Salon|Salon diseinua
Reservas|erreserbak
Salones|saloi
Reserva|erreserban
Total|guztira
Tablet Activada|Tablet aktibatuta
Visor Pedidos|Ordena ikuslea
Bit|pixka
Pedido Telefonico|Telefonoaren agindua
Envio|entrega
Juntar Cuentas|Erregistratu kontuak
SALON|SALON
EMPLEADO|LANGILE
codigoempleado|langile kodea
PEDIDO|ORDER
H. INICIO|H. HASIERA
MESA|TABLE
Cant.|Cant.
Precio|prezioa
Primero|lehenengo
Segundo|bigarren
Postre|postrea
Desc|DESC
Num_Factura|Num_Factura
Recargo|errekargua
Producto de Menu|Menu-produktua
Menu|Menu
Codigo del Menu|Menu-kodea
Servido|zerbitzatzen
Tipo de Impuesto|Zerga mota
Cod Empleado|Bakar-langilea
codigo Familia|Familia kodea
Indice|Edukiak
Cod. Prod.|Cod. Prod.
Orden Menu|Agindua menua
ZonaImpresion|Inprimatzeko eremua
BEBIDAS/ POSTRES|BEHERAPENAK / POSTREAK
PRIMER PLATO|LEHEN PLANA
SEGUNDO PLATO|SECOND PLATE
situacion panel producto|produktu panelaren egoera
Opciones|aukera
Cobrar|kobratzen
Abrir  Cajetin|Ireki kutxatila
Preticket|Preticket
Enviar a cocina|Sukaldera bidali
Borrar Venta|Ezabatu salmenta
Observ. Pedido|Ikusi dut ordena
Crear/Modificar Salones|Sortu / aldatu gelak
Diseño de Salones|Gela diseinua
Elementos para  el diseño|Diseinuko elementuak
Posicion del objeto/mesa|Objektu / taularen kokapena
Eliminar Mesa|Kendu taula
Eliminar Objeto|Ezabatu objektua
Guardar Numero|Gorde zenbakia
Numero Mesa|Zenbakiaren taula
Eliminar Diseño Salon|Kendu diseinu aretoa
Boton Pulsado|Pulsed Button
Objeto Pulsado|Pultsatutako objektua
Esta diseñando el:|Diseinatzen ari da:
Alta Salones/ Barra|Goi-aretoak / taberna
Lista de Salones - Barras|Aretoen zerrenda - Tabernak
Recargo:|errekargua:
Posicion En Pantalla:|Pantailaren kokapena:
Color Salon|Color Salon
Imagen Mesas|Irudi taulak
Nro de Mesas:|Taulen kopurua:
Imagen Salon|Salon irudia
Cambiar Idioma / Change Language|Aldatu hizkuntza / aldatu hizkuntza
Base De Datos|Database
Contraseña Director|Zuzendariaren pasahitza
Importar Imagenes del Servidor|Inportatu irudiak zerbitzaritik
Permisos Usuario|Erabiltzailearen baimenak
Importar Datos|Inportatu datuak
Cierre Año|Urte hurbila
Envio Informes|Bidalketa txostenak
Conexion en Red|Sareko konexioa
Aumento Precio|Handitu prezioa
Horario|ordutegia
Diseño Ticket / Factura|Ticket Design / Faktura
Cajetin|box
Impresoras|inprimatzaile
Copia de Seguridad|Babeskopiaren kopia
Configuracion Regional|Eskualdeko ezarpenak
Datos de la empresa|Enpresaren datuak
situacionpaneles|situacionpaneles
Esta a punto de restaurar una copia de seguridad, recuerde que este proceso es irreversible y cambiara la base de datos con la que trabaja en estos momentos por la seleccionada |Babeskopia berreskuratu nahi baduzu, gogoratu prozesu hori ezeztaezina dela eta aukeratutako unean lan egiten ari zaren datu basea aldatuko du
Hacer Copia de Seguridad|Egin babeskopia
Restaurar Copia de Seguridad|Berreskuratu babeskopia
Administracion Permisos|Baimenak Administrazioa
Nro. de copias del preticket|Pre-ticket kopiak
Nro. de copias del ticket|Txartelaren kopia kopurua
Centrado|zentratua
OFF|OFF
ON|ON
Enviar Confirmacion Reserva|Bidali baieztapenaren erreserba
Enviar email al director / cierre caja|Bidali posta elektronikoa zuzendari / itxiera koadroan
Realizar cierre caja ciego|Egin itxi itsu kutxa
Pedir Contraseña Al Entrar Al Programa|Eska ezazu pasahitza Programan sartzean
Permisos Usuarios|Erabiltzaile baimenak
Pedir contraseña para las modificaciones / eliminaciones / descuentos ... (Para todos los empleados)|Galdetu pasahitza aldaketak / ezabatzeak / deskontuak ... (Langile guztiei)
Pedir Contraseña Apertura de Cajetin|Eska ezazu pasahitza kutxatila irekitzea
Pedir Contraseña Al Entrar Caja|Galdetu pasahitza koadroan sartuz
Pedir Empleado Al Entrar Caja|Galdetu langilea koadroan sartuz
Activar Opciones|Aktibatu Aukerak
Pedir Contraseña|Galdetu pasahitza
Pedir Empleado X Cada Venta|Galdetu langilea X ​​salmenta bakoitzean
Utilizar Caja Rapida|Erabili Quick Box
Entrar en modo Direccion|Idatzi Helbide moduan
¿Ha olvidado su contraseña?|Zure pasahitza ahaztu al zaizu?
No ha seleccionado ningun empleado|Ez duzu langilerik aukeratu
Ingrese su clave:|Idatzi zure pasahitza:
SELECCIONE EL EMPLEADO|SELECT THE EMPLOYEE
Nombre de la Empresa|Enpresaren izena
Ingrese el nro. de percha|Idatzi zenbakia zintzilikarioa
lb-_Empleado|lb-_Empleado
Cambio Precio|Aldatu prezioa
Cierre De Caja|Box Itxiera
Imprimir Resguardo|Inprimatu Resguardo
Imprimir Ticket|Inprimatu Ticket
Abrir Cajetin|Ireki kutxatila
Terminar Venta|Amaitu salmenta
Importe Total Prendas|Guztira zenbatekoa arropa
Entrega cliente|Bezeroaren entrega
Devolucion|Itzulia
Venta Anterior|Aurreko salmenta
Nro Prendas|Arropa kopurua
Caja - Ropero|Kutxa - Armairua
Entrada Seleccionada|Hautatutako sarrera
Entrada + consumicion|Sarrera + kontsumoa
Entrada Seleccionada:|Hautatutako sarrera:
Seleccion De Entradas|Sarreren aukeraketa
Nombre del Visor:|Ikuslearen izena:
Utilizar Visor|Erabili ikuslea
Eliminar Impresoras de este teminal|Kendu inprimagailuak terminal honetatik
La impresora se ha dado de alta correctamente|Inprimagailua erregistratu da
Seleccione la celda en la interseccion de la impresora y la zona que quiere asociar|Hautatu gelaxka inprimagailuaren elkargunean eta erlazionatu nahi duzun eremua
Configuracion de Impresoras|Inprimagailuaren konfigurazioa
Gestion de Impresoras|Inprimagailuen kudeaketa
Reenvio de Pedidos A cocina / Barra|Bidalketak aginduak Sukaldea / Taberna
* click en la linea que desea reimprimir|* Erreproduzitu nahi duzun lerroan klik egin
Zona Impresion|Inpresioaren eremua
Hora|denbora
numPedido|ordno I
Fecha|data
enviado|envoy
Detalles del Pedido|Aginduaren xehetasunak
Reenviar|aurrera
NumPedido =|OrdenNum =
Guardar|gorde
Descuento a aplicar|Deskontua aplikatzeko
lblCliente|lblCliente
Terminar Venta <F12>|Amaitu salmenta <F12>
Descuento|deskontua
Buscar Cliente|Bilatu bezeroarentzako
Cambio|aldaketaren
Cliente entrega Efectivo|Diru-sarreren bezeroa
Cliente paga con Tarjeta|Bezeroak txartela ordaintzen du
Formato de Impresion|Inprimatzeko formatua
Formato A4|A4 formatua
Formato A5|Formatua A5
Tamaño 10 cm.|Tamaina 10 cm.
Imprimir factura|Inprimatu faktura
SubTotal|SUBTOTAL
Propina|punta
Enviar ticket Correo Electronico|Bidali txartela E-mail
Cerrar Venta|Itxi salmenta
Imprimir en Cocina|Inprimatu sukaldean
V E R  T I C K E T|V E R T I C K E T
Tipo de venta|Salmenta mota
Factura|faktura
Boleta Formato Ticket|Ticket Format Ticket
Ultima Venta|Azken salmenta
Diseño de salon|Salon diseinua
Eliminar Venta Ya Cobrada|Ezabatu salmenta dagoeneko biltzen
Cobro Parcial|Bilduma partziala
Reservas de Mesas|Taulen erreserbak
Listados Caja|Zerrendak kutxa
Retirada de Caja|Kutxako ateratzea
Gastos del Dia|Eguneko gastuak
Activar Precios para este Terminal|Aktibatu Terminal honen prezioak
Reimpresion Ticket|Txartela errepikatzea
Modificacion de Tickets|Sarreren aldaketa
Conteo y cierre de caja|Eskudiru kontua eta itxiera
situacion panel opciones|panelaren egoera aukerak
panel_opciones de caja|panel_opciones cash
CONFIGURACION OPCIONES CAJA|KONFIGURAZIO-KUTXA AUKERAK
Regresar al idioma original|Itzuli jatorrizko hizkuntzan
¿Confirma que desea eliminar el siguiente registro?|Ziur al zaude hurrengo erregistroa ezabatu nahi duzula?
Idiomas|hizkuntzak
Usted ha seleccionado|Hautatzen duzu
Ninguno|bat ere ez
¿Seleccione el Idioma?|Hautatu hizkuntza?
Texto Traducido|Itzulitako testua
Texto Original|Jatorrizko testua
id|id
Texto|testua
Traduccion|itzulpen
lineas sin traducir|lerro ez itzulitakoak
Click sobre la linea para añadir una traduccion|Egin klik lerroan itzulpen bat gehitzeko
Click sobre la linea para modificar la traduccion|Egin klik lerroan itzulpenak aldatzeko
Texto sin traducir|Testu mugagabea
Condiciones|Termino
Registro de Licencias|Lizentzien erregistroa
Acerca de ...|Buruz ...
TPV Gratuito|Doako POS
B. Aires - Argentina|B. Aires - Argentina
D. F. - Mexico|D. F. - México
Santiago de Chile|Santiago, Chile
Lima - Peru|Lima - Peru
Costa Rica|Costa Rica
Puerto Rico|Puerto Rico
Miami - Florida|Miami - Florida
Bogota - Colombia|Bogotá - Kolonbia
Mantenimiento registrado hasta:|Mantentze erregistratua honetara:
Fecha de Caducidad:|Iraungitze data:
Fecha de Instalacion:|Instalazioaren eguna:
TPV Gratuito, Departamento de Desarrollo|Doako POS, Garapen Departamentua
Ultima actualizacion: XXX|Azken eguneratzea: XXX
Fecha de creacion:  XXX|Sorkuntza data: XXX
Proyecto: Tpv 123, Version: XXX|Proiektua: Tpv 123, bertsioa: XXX
Paseo de Europa 7, (S.S. de los Reyes - Madrid -España)|Paseo de Europa 7, (S. de los Reyes - Madrid-España)
Buenos Aires - Argentina|Buenos Aires - Argentina
E-mail: compras@tpvgratuito.com   www.tpvgratuito.com|E-posta: compras@tpvgratuito.com www.tpvgratuito.com
Servicio de asistencia:|Helpdesk:
Reg. Anual|Urteko Erreg
Usted está utilizando una licencia:|Lizentzia bat erabiltzen ari zara:
SolverMedia|SolverMedia
SolverMedia, Departamento de Desarrollo|SolverMedia, Garapen Departamentua
Fecha de creacion: XXX|Sorkuntza data: XXX
Proyecto: Servidor Net, Version: XXX|Proiektua: zerbitzari garbia, bertsioa: XXX
No hay datos para ser mostrados|Ez dago datuik erakusteko
Listado de Empleados|Langileen zerrenda
Listado de Familias|Familien zerrenda
Listados Generales|Zerrenda orokorrak
Ventas NCF Rep. Dominicana|Sales NCF Rep. Dominicana
Ventas con Promociones|Promozioak dituzten salmentak
Productos Bajo Minimo|Produktu txikiak gutxienekoak
Reimprimir Factura - Ticket|Erreprimitu faktura - Txartela
Ventas x Clientes|Salmentak x Bezeroak
Imprimir Letreros  y  Etiquetas |Inprimatu errotuluak eta etiketak
Estadisticas|Estatistikak
Valoracion Stock x Proveedores|Balioaren balorazioa x hornitzaileak
Valoracion Stock General|Balorazio orokorreko balioa
Listado de Proveedores|Hornitzaileen zerrenda
Listado de Clientes|Bezeroen zerrenda
Listado de Productos|Produktuen zerrenda
Servicios a Domicilio|Etxeko zerbitzuak
Consumo de Platos Menu|Arropa kontsumitzeko menua
Reservas x Dia|Erreserbak x eguna
Pedidos Realizados a Proveedor|Hornitzaileentzako egindako eskaerak
Empleado del Mes|Hilabeteko langilea
Estadistica x Repartidor|Estatistikak x Saltzaile
Retiradas Empleados|Langileen baja
Relacion Envios Cocina contra Ventas|Bidalketa harremanak Kitchen vs. Sales
Formato Din-A4|Din-A4 formatua
Formato Ticket|Txartel formatua
Total Diario de Retiradas|Guztira eguneroko ateratzeak
Ventas x Zonas|Salmentak x Arloak
Caja Total x Dias|Guztira Box x egunak
Gastos de Caja|Diruzaintzako gastuak
Descuentos Realizados|Deskontuak egindakoak
Ventas en el mes (Acumulado x Horas)|Hilabeteko salmentak (Eguneratutako orduak)
Reservas Hora/Dia /Mes|Erreserbak Denbora / Eguna / Hilabetea
Ventas x Empleados|Salmentak x Langileak
Impuestos Repercutidos|Zergak kenkaria
Gastos|gastuak
Relacion de Propinas|Punta-erlazioa
Ventas x Menus|Salmentak x Menuak
Resumen Contable de Facturas|Faktura kontabilitatearen laburpena
Productos mas Vendidos|Gehien saltzen diren produktuak
Productos Sin Ventas|Salmentarik gabeko produktuak
Ventas x Horas|Sales orduak
Resumen de Venta x Empleados|Salmentaren laburpena x Langileak
Ventas Detalladas x Empleados|Salmentak x Langileak
Ventas Eliminadas y Descuentos|Salmentak eta deskontuak ezabatuak
Ventas x Zonas -Totalizado x Productos|Salmentak x Arloak -Totalizatutako x produktuak
Ventas Generales x Dia|Sales General x Day
Ventas x Familias|Salmentak x Familiak
Ventas x Zonas Formato General|Sales x Arloak Formatu orokorra
Ventas x Forma de Pago|Salmentak ordaintzeko formularioa
Ventas Formato Ticket Resumido|Salmentaren laburpena Ticket formatua
Ventas Formato Ticket x Empleado|Salmentako formatua Ticket x Langilea
Productos Bajo Minimos Formato Ticket|Formatu Minimaleko Txartelaren azpiko Produktuak
Ventas Eliminadas Formato Ticket|Salmentak ezabatutako formatuan
Cierres de Caja Formato Ticket|Cashier Itxiera Formatuaren txartela
Ventas Formato Ticket Detallado|Salmentak Ticket formatu zehatza
Subproductos|azpiproduktuak
Eliminar Datos de Prueba|Ezabatu test datuak
Configuracion Empresa|Enpresaren konfigurazioa
Datos de la Factura|Faktura datuak
Ultimo Nro. Utilizado = |Azken erabilia ez =
Factura Numero|Bill zenbakia
Numeracion de factura|Faktura zenbakia
No Incluidos|Ez dago barne
Incluidos|sartuta
Impuestos|fiskalitatea
Ancho A5 (14cm)|Zabalera A5 (14 cm)
Ancho 10 cm|Zabalera 10 cm
Ancho A4 (21cm)|Zabalera A4 (21 cm)
Formato de Factura|Faktura formatua
Logo de la Empresa|Enpresa logotipoa
Pagina Web|webgune
Direccion|helbidea
Pais|Herria
Codigo Postal|Postal Kodea
Detalles de la Empresa|Enpresa datuak
Recuerde que en la carpeta indicada en la linea superior tiene que existir el archivo nomprog.|Gogoratu goiko lerroan adierazitako karpetan nomprog fitxategia behar dela.
Paso1: Confirme que todos sus equipos esten conectados en red.  Paso2: De todos los equipos que tiene, tiene que seleccionar uno que va a hacer de servidor.  Paso3: El equipo que hara de servidor tiene que tener el disco C compartido y con los permiso|1. urratsa: berretsi ordenagailuak sare batean konektatuta dagoela. Urratsa 2: Zure ekipo guztietatik, zerbitzari bat hautatu behar duzu. 3. urratsa: Zerbitzariak disko partekatua eta baimenarekin izan behar duen taldea izan behar du
Nota: Localice el equipo que hara de servidor que la base de datos la encontrara en |Oharra: kokatu zerbitzaria datu-basea aurkitzen duen ordenagailua kokatzeko
Conectar con la base de datos|Datu-basearekin konektatu
Como tiene que poner su equipo  en modo red local (varios equipos)|Nola jarri zure ordenagailua sare lokal moduan (hainbat ordenagailu)
Conexion con otro Terminal|Beste terminal batera konektatzea
Permisos de Usuario|Erabiltzailearen baimenak
Seleccione el empleado al que va a configurar permisos|Aukeratu langilea noren baimenak ezarri nahi dituzun
Cambio Guardado|Gordetako aldaketa
Cambio de Clave|Aldatu pasahitza
* Maximo 8 caracteres|* Gehienez 8 karaktere
Confirmacion|berrespena
Nueva|berriaren
Antigua|Antigua
Cambiar Contraseña|Aldatu pasahitza
Cambios guardados|Aldaketa gordeak
Aplicar Cambios para este Empleado|Aplikatu langile honen aldaketak
Borrar Restricciones|Ezabatu murriztapenak
Opciones configurables|Aukera konfiguragarriak
NO Permite acceso al modulo|NO Modulora sartzeko aukera ematen du
Permite acceso al modulo|Modulora sartzeko aukera ematen du
Seleccione su pais|Hautatu zure herrialdea
Nombre del Impuesto (IVA, IGIC, IGV, etc.)|Zergaren izena (BEZ, IGIC, IGV, etab.)
Si en su pais no se aplica esta normativa, NO ACTIVE esta opcion|Araudi hau ez bada zure herrialdean aplikatzen, EZ aktibatu aukera hau
Si ACTIVA esta opcion, en las facturas el num. le aparecera asi: 000- 000-00-0000000X|Aukera hau aktibatzen baduzu, fakturak zenbakiak dituzu. Horrelakoa izango da: 000-000-00-0000000X
En algunos paises la normativa indica que el numero de facturas tiene que ir precedido por una serie de identificadores.|Zenbait herrialdetan, araudiek adierazten dute fakturak identifikatzaile kopuru bat baino gehiago izan behar direla.
INFORMACION SOBRE FACTURAS ESPECIALES|INFORMAZIOA BEREZITASUN BEREZIAK
Moneda|moneta
Simbolo Moneda|Moneta ikurra
Formato Hora:|Denbora formatua:
Numero de decimales ( 0,1,2)|Zenbaki hamartarrak (0,1,2)
Identificacion Fiscal (Cif, Nif, Ruc, Rut, Rnc, etc.)|Zerga-identifikazioa (Cif, Nif, Ruc, Rut, Rnc, etab.)
h=12 Horas (AM o PM)|h = 12 ordu (AM edo PM)
h=24 Horas |h = 24 ordu
Otra Moneda|Beste Moneta
Btc 1 BitCoin = |Btc 1 BitCoin =
€ 1 Euro = |Euro 1 euro =
$ 1 Dolar = |$ 1 dolarra =
Hasta 8 decimales|Gehienez 8 hamarren
Numero de credito fiscal|Zerga kreditu-zenbakia
Activar linea propina en preticket|Aktibatu punta lerroa aurrefabrikatuan
Guardar Cambios|Gorde aldaketak
Ingrese el concepto|Idatzi kontzeptua
Activar concepto Propina / Servicio / Otros|Aktibatu kontzeptua Tipping / Service / Other
(Opcion utilizada con frecuencia en algunos paises del caribe y sudameria) / No activar en paises en los que no es obligatorio cobrar propina|(Karibeko eta Sudamerako herrialde batzuetan maiz erabiltzen diren aukerak) / Ez aktibatu aholkuak kobratzeko beharrik ez dagoen herrialdeetan.
Secuencia de Apertura|Sekuentzia irekitzea
Para impresoras conexion paralela:|Konexio paralelo inprimagailuak:
Probar / Guardar|Probatu / gorde
* Click para seleccionar la secuencia de apertura|* Egin klik irekitzeko sekuentzia hautatzeko
Marca de Impresora|Inprimagailuaren marka
Modelo de Impresora|Inprimagailuaren eredua
Otras secuencias de apertura|Beste irekitzeko sekuentziak
Nota: Es posible que la impresora realice el corte sin tener que añadir ninguna secuencia de apertura, en ese caso no hace falta que configure esta opcion|Oharra: baliteke inprimagailuak ebaki egiten duela sekuentzia irekirik gabe, kasu horretan ez duzu aukera hau konfiguratu beharrik
* Click para seleccionar la secuencia de corte|* Egin klik ebaketa sekuentzia aukeratzeko
Secuencia de Corte|Ebaketa sekuentzia
Otras secuencias de Corte de Papel|Paper ebakien beste sekuentziak
Configuracion de corte automatico al final del ticket:|Txartelaren amaieran ebaketa automatikoko konfigurazioa:
¿Que son comandos adicionales? Despues de instalar los drivers de la impresora en propiedades de la misma encontramos una pestaña de comandos adicionales / desde aqui marcaremos la opcion de apertura de cajon (Open Draw1 o Open Draw2).|Zer dira komando gehigarriak? Inprimagailuaren kontrolatzaileak propietateetan instalatu ondoren, komando osagarrien fitxa bat aurkitu / hemendik tiradera irekitzeko aukera (Ireki Draw1 edo Open Draw2) markatzen dugu.
Apertura estandar para impresoras USB|USB inprimagailuen irekiera estandarra
Para impresoras con comandos adicionales: (serie, paralelo, usb)|Komando gehigarriak dituzten inprimagailuak: (serieak, paraleloak, usbak)
Para impresoras salida serie:|Irteerako serieko inprimagailuak:
Configuracion de Apertura de Cajon|Cajon irekiera konfigurazioa
Si conoce que tipo de conexion tiene su impresora de tickets seleccione la que le corresponde en caso contrario pruebe cada uno de ellos hasta confirmar cual es el que abre.|Badakizu zein motatakoa den zure txartelaren inprimagailua duen konexioa, hautatu dagokionari dagokionez, saiatu horietako bakoitza baieztatu zein den irekitzen den arte.
Ayuda|lagundu
Configuracion de Cajetin|Aldizkariaren konfigurazioa
Courier New|Courier New
Seleccione Tamaño Letra: Cuerpo|Aukeratu Letra Tamaina: Gorputza
Seleccione Tamaño Letra: Titulo|Aukeratu Letra Tamaina: Titulua
Seleccione Tipo Letra|Aukeratu letra mota
Tipo / Tamaño Letra|Idatzi / Tamaina Letra
Nro. de Decimales que quiero utilizar|Erabili nahi dudan hamartarren kopurua
Mi impresora imprime|Nire inprimagailuak inprimatzen ditu
Nro. de caracteres de su impresora|Zure inprimagailuko karaktere kopurua
caracteres por linea|lerroko karaktereak
Poblacion:|populazio:
Direccion:|helbidea:
Tel:|Tel:
CIF / DNI:|ZIF / NAN:
Cliente:|bezeroa:
Empleado:|Langilea:
Fact. Simpli:|Izan ere. simpli:
Codigo Barras|Bar Kodea
Lineas en blanco al final del ticket = |Txartelaren amaieran lerro hutsak =
Escriba aqui su comentario del final de ticket|Idatzi hemen zure iruzkina
** Gracias por su visita **|** Eskerrik asko zure bisita **
Impuestos Incluidos|Zergak barne
Varias lineas para descripcion del producto|Hainbat produktu deskribapen lerro
Añadir codigo de barras en descripcion de producto|Gehitu kode-barra produktuaren deskribapenean
Otras Opciones|Beste aukera batzuk
Mostrar P. Unitario|Erakutsi P. Unitaria
Desglose Impuesto|Zerga-banaketa
Total en Letras|Letren guztira
Utilizar SubTotal|Erabili subtotala
Cuota|kuota
Base|oinarria
Tipo IVA|BEZ mota
Entrega|entrega
P. U.|P. U.
Descripcion|deskribapena
Uds|duzu
WEB|WEB
Puede cambiar|Aldatu egin dezakezu
CIF|CIF
Nombre Empresa|Enpresaren izena
Imagen al Principio|Hasierako irudia
Datos de Cabecera|Goiburuko datuak
Clic para cambiar Imagen|Egin klik irudia aldatzeko
Nro Venta/Pie de Ticket|Ez da salmenta / sarreren oina
Diseño Ticket|Ticket Design
Valor de venta en letras|Salmenta hizkuntzan
Diseño de Ticket|Txartelaren diseinua
Pie de Ticket|Txartelaren oina
Detalles del  Ticket|Txartelaren xehetasunak
Vista Previa|Aurreikuspen
Cabecera  Ticket|Txartelaren goiburua
Datos del  Cliente|Bezeroaren datuak
Clave:|gakoa:
Usuario: Director|Erabiltzailea: zuzendaria
Está a punto de realizar la restauración de sus copias de seguridad de sus bases de datos.  Para ello deberá localizar su copia de seguridad en su disco duro o en su modulo de memoria extraible.  Dicha operación demorará unos segundos, una vez finaliz|Zure datu-baseen babeskopiaren kopiak berreskuratu nahi dituzu. Horretarako, babeskopia zure disko gogorrean edo memoria memoria aldagarrian kokatu behar duzu. Esandako operazioek segundo batzuk iraungo dute behin amaitutakoan
TPV Hosteleria|POS Terminal Hosteleria
Grafica de Envios|Bidalketa grafikoak
Relacion Emails Enviados|Erantzun mezu elektronikoen bidalketak
Envio Promocion|Bidalketa Sustapena
Crear Plantillas Reservas|Sortu txantiloiak erreserbak
Envio Puntual|Bidalketa egokian
Crear Plantillas|Sortu txantiloiak
Activar Servicio De Correos|Aktibatu posta zerbitzua
Enviados:|bidali
Label6|Label6
Saldo:|oreka:
Su ID Es|Zure IDa da
Servicio Correo|Posta zerbitzua
Le hemos asignado  20 correos gratis|Doako 20 e-postak esleitu dizkiegu
Su registro se ha realizado con exito|Zure izena ongi burutu da
Nombre de Usuario|Erabiltzaile izena
Correo de Contacto|Harremanetarako posta elektronikoa
Incluir Logo|Sartu logotipoa
Pie de Correo|Foot Mail
Configuracion Correo|Posta konfiguratzea
Mensaje Enviado|Bidalitako mezua
Enviar|bidali
Envio Puntual de Correo|Posta bidaltzea
toolStrip1|toolStrip1
Mensaje|mezua
Remitente|bidaltzailea
Asunto|negozio
Destinatario|hartzaileak
Seleccione el intervalo de fechas|Hautatu data-tartea
Chart1|chart1
Grafico|grafikoa
Nueva Plantilla|Txantiloia berria
Plantillas Promociones|Promozioak txantiloiak
Guardado Correctamente|Gorde zuzen
No|ez
Sí|bai
¿Desea cargar el diseño anterior?|Aurreko diseinua kargatu nahi duzu?
Nombre Plantilla|Txantiloi izena
Plantilla 3|Txantiloia 3
Plantilla 2|Txantiloia 2
Plantilla 1|Txantiloia 1
Plantilla|template
<---- Texto que aparece en el cuerpo de la promocion|<---- Sustapenaren gorputzean agertzen den testua
<---- Escriba el  texto que desea que aparezca en la parte inferior de la promocion|<---- Sustapenaren behealdean agertu nahi duzun testua idaztea
<---- Escriba el titulo o el texto que desea que aparezca en la cabecera de la promocion|<---- Sustapenaren goiburuan agertu nahi duzun izenburua edo testua idatzi
Pie de página|Orri-oina
Titulo|Izenburua
<---- Haga un click para insertar la imagen|<---- Egin klik irudian txertatzeko
Plantilla Guardada|Gordetako txantiloia
Cuerpo del Mensaje|Mezuen gorputza
Plantilla Reservas|Txantiloien erreserbak
<---- Texto que se genera automaticamente|<---- Automatikoki sortzen den testua
<---- Escriba el  texto que desea que aparezca en la parte inferior de la reserva|<---- Erreserba behealdean agertu nahi duzun testua idaztea
<---- Escriba el titulo o el texto que desea que aparezca en la cabecera de la reserva|<---- Idatzi izenburua edo testua erreserba-goiburuan agertu nahi duzun
Configurar Email|Konfiguratu posta elektronikoa
Mostrar clientes|Erakutsi bezeroak
Filtrar Clientes para Enviar Email|Iragazkien bezeroak Bidali posta elektronikoa
Seleccione una opcion|Hautatu aukera bat
Menor que|Gutxiago baino
Mayor que|Handiagoak baino
Consumo|kontsumoa
Ingrese un codigo postal|Idatzi posta-kodea
Todos los clientes|Bezero guztiak
Num. Visita|Bisitatu zenbakia
Cumpleaños|urtebetetze
Enviando Emails|Posta elektronikoak bidaltzea
Cerrar|itxi
Ctrl+C para copiar los correos de esta lista para hacer un envio desde la aplicacion de correo electronico (gmail, hotmail, etc...) que desee.|Ktrl + C zerrenda honetako mezu elektronikoak kopiatzeko, bidali nahi duzun posta elektronikoko aplikaziotik (gmail, hotmail, eta abar).
Lista de correos seleccionados|Hautatutako mezu elektronikoak
Enviar Email a Clientes Seleccionados|Bidali mezu elektronikoak hautatutako bezeroei
Lista de clientes|Bezeroen zerrenda
 Mostrar Todos| Erakutsi guztiak
Emails Seleccionados|Hautatutako mezu elektronikoak
Marcar Todos|Markatu guztiak
Copiar Emails seleccionados  para envio manual|Kopiatu hautatutako mezu elektronikoak eskuz bidalketarako
 Mostrar solo con Email Valido| Erakutsi soilik posta elektronikoz
Clientes Seleccionados|Hautatutako bezeroak
Cantidad de clientes que cumplen las condiciones|Baldintza betetzen dituzten bezero kopurua
Importe|Zenbateko
Visitas|bisitak
* Si no pone un correo electronico valido no recibirá respuesta|* Ez baduzu baliozko mezu elektronikorik jarri, ez duzu erantzunik jasoko
Telefono:|telefono:
Email: *|Posta elektronikoa: *
Ingrese sus datos para poder responderle|Sartu zure informazioa erantzuteko
Formule su Consulta|Galdetu zure galdera
Aviso de averia|Breakdown notice
Pregunta o Consulta|Galdera edo kontsulta
Tipo de Consulta|Kontsulta mota
Si tiene alguna Incidencia / Pregunta sobre nuestro programa utilice esta opcion siguiendo los pasos:|Gure programa honi buruzko Incidentzia / Galderarik baduzu, erabili urrats hauek jarraituz:
Aviso de Averia / Consulta|Abisua / Kontsulta
Asistencia y Sugerencias|Laguntza eta Iradokizunak
Si no tiene contratado este servicio nuestra empresa no tiene la obligacion de dar ningun tipo de servicio o ser responsable de algun cambio de su sistema informatico.|Zerbitzu hau kontratatu ez baduzu, gure konpainiak ez du inolako zerbitzurik eman beharrik edo zure sistema informatikoan aldaketak egiteko ardura izango du.
Si la compra de este producto ha superado el año y tiene caducado la asistencia / actualizaciones del programa, y tiene un problema recuerde, primero contratar nuestro servicio de asistencia para una solucion adecuada.|Produktu honen erosketak urteak gainditu badu eta programaren laguntza / eguneratzeak iraungi egin badira eta arazo bat gogoratzen baduzu, lehenik, gure laguntza-zerbitzua alokatu behar da irtenbide egokia lortzeko.
Cambio de equipo informatico, cambio de disco duro, formateo de disco duro, etc...|Aldaketa ordenagailu ekipoak, disko gogorreko disko gogorreko formatua, eta abar ...
4.- Estimado cliente recuerde que sólo podrá recibir las actualizaciones del programa en caso de tener el contrato de mantenimiento al día.|4.- Bezero zoragarria, gogoratu programa eguneratzeak bakarrik jaso ditzakezula mantentze-kontratua eguneratuta duzula.
3.- Si se produce alguno de estos casos anteriores, antes de realizar ninguna acción,  pongase en contacto con el departamento técnico de SolverMedia comercial@solvermedia.com para que le ayuden a realizar el cambio.|3.- Aurreko kasu hauetakoren bat gertatuz gero, edozein ekintza egin aurretik, jarri harremanetan SolverMedia comercial@solvermedia.com zerbitzu teknikoarekin aldaketa egiteko.
2.- La empresa SolverMedia no concederá una nueva licencia a aquellos clientes que por problemas ajenos a SolverMedia hallan perdido el registro del programa, esos problemas pueden venir causados por:|2.- SolverMedia konpainiak ez du baimen berri bat emango bezeroei, SolverMedia-ren inguruan arazoak dituztenei, programaren erregistroa galdu dutelako. Horrelako arazoak honako hauek dira:
1.- La empresa SolverMedia no se responsabiliza de la mala manipulación de su registro de licencia así como del numero asignado para su registro.|1.- SolverMedia konpainiak ez du erreklamaziorik bere lizentzia erregistroaren manipulazio txarra eta erregistratzeko esleitutako kopurua.
La contraseña de direccion es: |Helbideen pasahitza hau da:
Maximo 8 caracteres|Gehienez 8 karaktere
Confirme la contraseña|Berretsi pasahitza
Ingrese la contraseña nueva|Idatzi pasahitz berria
Ingrese la contraseña anterior|Idatzi aurreko pasahitza
Recordatorio de contraseña de direccion|Helbideen pasahitza gogorarazteko
Cambio de contraseña de direccion|Helbideen pasahitza aldatu
Volver a intentar|Saiatu berriro
Las respuestas introducidas no son correctas|Erantzunak ez dira zuzena
Para poder recordarle la contraseña de direccion es necesario que responda a las siguientes preguntas|Helbide-pasahitza gogorarazteko, honako galdera hauek erantzun behar dituzu
Año|Urte
Mes|Hileko
Dia|egun
Ingrese el segundo apellido de su madre|Sartu zure ama bigarren abizena
Indique su fecha de nacimiento|Adierazi jaiotze data
Si olvida la contraseña que acaba de introducir podra recuperarla respondiendo a las preguntas anteriores.|Sartutako pasahitza ahaztu baduzu, berreskura dezakezu aurreko galderekin erantzunez.
La contraseña y las respuestas de recordatorio se han guardado correctamente.|Pasahitza eta gogorarazlearen erantzunak ondo gorde dira.
Boletas|Boto
Facturas|fakturak
codCliente|codCliente
Cliente|bezero
F.Pago|F. Ordainketa
** clic en la lista o introduzca el numero de ticket|** Egin klik zerrendan edo idatzi txartelaren zenbakia
Ingrese el numero de ticket / factura|Idatzi txartelaren zenbakia / faktura
Lista de las ultimas ventas|Azken salmenten zerrenda
Concepto del gasto|Kontzeptuaren gastua
Gastos Del Día|Eguneko gastuak
Ultimos 50 gastos (clic para modificar)|Azken 50 gastuak (klik egin aldatu)
ESPACIO|SPACE
BORRAR|CLEAR
Deja en Caja :|Utzi koadroan:
Cerrar Ventas/Imprimir|Itxi salmentak / Inprimatu
Observaciones de caja:|Diruaren behaketak:
Suma/Conteo de caja del turno actual|Sum / egungo maiuskulen zenbaketa
Seleccione las monedas de su pais|Hautatu zure herrialdeko moneta
Cargar monedas de la Zona Euro|Kargatu euroguneko txanponak
Valor n|Balioa n
Terminal = XXX|Terminal = XXX
Total monedas|Txanponak guztira
Total tarjetas|Txartelak guztira
Total otras formas de pago|Beste ordainketa metodo batzuk
Caja Inicial:|Hasierako dirua:
Num total de operaciones de este terminal|Terminal honen eragiketa kopurua
Num total operaciones otras formas pago|Zenbakizko eragiketen beste forma batzuk ordainketa
Num total operaciones tarjeta|Zenbakizko txartelen eragiketak
Num total operaciones contado|Kontuak zenbatutako guztirakoak
Max. 20|Max. 20
Número de tipos de moneda a utilizar:|Moneta motak erabili beharrekoa:
Seleccione las monedas en circulacion de su pais|Aukeratu zure herrialdeko zirkulazioko moneta
Tipo 20|Idatzi 20
Nota: Esta opcion solo esta pensado para aquellos clientes que en su pais el valor de sus monedas es diferente al establecido para la zona Euro.|Oharra: Aukera hau bere herrialdeko herrialdeetan beren moneta-balioa ezberdina da Eurogunerako ezarrita dagoenarengatik.
Importe a Retirar|Berreskuratzeko zenbatekoa
Retiradas|bajak
TELEF|TELEF
Borrando|obliterating
Hora Reserva|Erreserba ordua
Nro comensales|Ez dago dirurik
Todos|guztiak
Cena|afaria
Almuerzo|bazkaria
Desayuno|gosaria
MESAS =|TAULA =
H O R A S|H O R A S
Seleccione Horario|Aukeratu ordutegia
*Clic para seleccionar salon|* Egin klik gela hautatzeko
R e s e r v a s|R e s e r v a s
Diseñar Plantilla reserva|Diseinu txantiloia liburua
Nueva Reserva|Erreserba berria
Hora de Reserva|Erreserba ordua
Nro de Comensales|Diner kopurua
Teléfono|telefono
* Click en la columna de telefono para ver la direccion|* Egin klik telefonoaren zutabean helbidea ikusteko
Resultado de la Búsqueda|Bilaketa emaitza
Movil|Movil
C. Postal|C. Postala
Limpiar|garbi
DNI|DNI
Puerta:|atea:
Fijo / Movil|Fixed / Mobile
Piso:|solairua:
C. Postal:|C. Postala:
Número:|zenbakia:
Email:|email:
Modificar Datos|Aldatu datuak
Nuevo Cliente|Bezero berria
Activar Precios para este terminal de venta|Aktibatu prezioak salmenta terminal honetarako
Crear nueva o modificar una lista de precios existente|Sortu berri bat edo aldatu lehendik dagoen prezio zerrenda
Listas de Precios|Prezio zerrendak
Listas activa en este terminal|Terminal honetako zerrendak aktiboak
Listas de precios no activa|Prezio zerrendak ez daude aktiboak
La lista de precios que ha seleccionado esta fuera del rango actual|Aukeratutako prezio zerrenda uneko barrutitik kanpo dago
Nombre (click para seleccionar/desactivar)|Izena (klikatu / desaktibatzeko)
activa|aktibo
Fecha Alta|Data altua
Prod. en Lista|Zerrenda
Codigo Precio|Prezio Kodea
C. P.|C. P.
Cif / Dni|CIF / Dni
Realizando cambios|Aldaketak egitea
alturapanel|alturapanel
Los mismos pasos 1, 2 para margen comercial o precio de venta.|Urratsak 1, 2, merkataritza-marjina edo salmenta-prezioa.
* Clic sobre el impuesto que desea cambiar|* Egin klik zerga aldatzeko
De:|maila:
Cambio el valor de los impuestos|Aldatu zergen balioa
Deseo cambiar|Aldatu nahi dut
a:|a:
Nro. de Productos|Produktuen kopurua
2.-Luego seleccione el proveedor o seleccione la opcion todos.|2.- Ondoren, aukeratu hornitzailea edo hautatu guztia aukera.
Con redondeo|Biribiltzea
Sin redondeo|Biribildu gabe
Todos los productos|Produktu guztiak
Productos del Proveedor|Hornitzaileen produktuak
Coste|kostua
Cambio de Coste / Precio|Kostuen / Prezioaren aldaketa
1.-Si desea aumentar el coste, solo debe ingresar el porcentaje en la caja del mismo.|1.-Kostua handitu nahi baduzu, idatzi laukian ehunekoa.
Recuerde que este proceso es irreversible. Confirme y  verifique los porcentajes que está aumentando.|Gogoratu prozesu hori atzeraezina dela. Berretsi eta egiaztatu handitzen ari diren ehunekoak.
Este proceso automatiza el aumento de precio, margen comercial y coste de los productos.|Prozesu honek produktuaren prezioa, komertziala eta kostua gehitzen automatizatzen ditu.
Aumento de Precios|Prezioen hazkundea
Nombre Servidor SQL Server|Zerbitzariaren izena SQL Server
Utilizar  SQL   Server . . . . . |Erabili SQL Server . . . .
UTILIZAR SQL SERVER|USE SQL SERVIDOR
Más Información|Informazio gehiago
Dirigido para aquellas empresas con volumenes de datos altos o muchas interacciones simultaneas soporta varios PC conectados en red sin problemas de concurrencias y trafico de datos. (si este es su caso nuestro programa funciona perfectamente con este ges|Datu-bolumen handiko edo aldi baterako elkarrekintza ugari dituzten enpresei zuzenduta, hainbat sare-PC onartzen ditu concurrent problems and data traffic gabe. (Hau da zure kasua bada, gure programa ondo funtzionatzen du gezekin
SQL SERVER|SQL zerbitzaria
Indicado para empresas con volumen de datos bajos 1 o 2 PC en red.|Datuen bolumen baxuko enpresei zuzenduta dago 1 edo 2 PC sarean.
ACCESS|SARBIDEA
El Tipo de Base De Datos Que Su Negocio Necesita|Zure Enpresa Beharren datu-basea
Pasar a la version Basica o Completa|Joan Oinarrizko edo Bete bertsioara
Configure los Horarios de su establecimiento|Konfiguratu zure establezimenduaren ordutegiak
Label2|lABEL2
a |to
El Horario del Establecimiento es:|Establezimenduen Ordutegia:
El Horario de Cocina es:|Sukaldeko ordutegia hau da:
Seleccione el Horario del Establecimiento|Aukeratu establezimenduaren ordutegia
Seleccione el Horario de Cocina|Aukeratu Kitchen ordutegia
4.- Solo le recomendamos que contrate este servicio y utilice esta opcion si solo si su empresa verdaderamente lo necesita, por nuestra experiencia el 90% de los usuarios de Puntos de Venta del sector retail no necesitan tener esta base de datos instalada|4.- Zerbitzu hau kontratatu eta aukera hau erabiltzea gomendatzen dugu bakarrik, zure enpresak benetan behar badu, gure esperientzia txikizkako sektoreko Saltokien erabiltzaileen% 90ek ez dute behar datu-basea instalatuta
3.- Tiene que indicarnos los nombre de los usuarios que utilizaran el programa para crear los usuarios en la base de datos. (este servicio incluye 3 usuarios si desea mas usuarios el coste es de 5 Euros por cada uno)|3.- Programa erabiltzen duten erabiltzaileek datu-basea sortzeko erabiltzaileen izenak adierazi behar dituzu. (zerbitzu honek 3 erabiltzaile ditu erabiltzaile gehiago nahi badituzu, kostua 5 eurokoa da)
2.- Tiene que tener instalado el TeamViewer para que un tecnico pueda conectar a instalar la BD y dejarle el programa funcionando en Sql Server|2.- TeamViewer instalatuta eduki behar duzu teknikari batek instalatu BD instalatzeko eta programa exekutatzen utzi Sql Server-en
1.- Este servicio tiene un coste de 75 Euros + Iva|1.- Zerbitzu honek 75 euro + BEZa du
Si desea utilizar el programa con Sql Server un tecnico de nuestra empresa se lo puede instalar. Pasos que tiene que tomar en cuenta.|Programa Sql Server-ekin erabili nahi baduzu, gure enpresako teknikariak instalatu dezake. Kontuan hartu beharreko urratsak.
Requisitos Para Usar Sql Server|Sql Server erabiltzeko baldintzak
Numero de Ventas Menores A: |Salmenta txikien kopurua A:
Seleccione de que terminal quiere obtener la información|Hautatu zein terminal lortu nahi duzun
Servicios|zerbitzuak
Completo|osoa
Total General|Guztira orokorra
Total Gastos|Gastu osoa
C. Inicial|C. Hasierako
Total Retiradas|Guztira ateratzeak
Totalizado por Forma de Pago|Ordainketen formularioaren bidez beteta
Ventas Generales por Dia|Eguneko salmentak
Esta Forma de Pago es de tipo Tarjeta|Ordainketa modua txartela da
Nueva Observación|Behaketa berria
comensal|afari
Observacion|Behaketa
estado|egoera
idenvio|idenvio
Seleccione la observacion que desea eliminar del panel de arriba|Hautatu gainetik kendu nahi duzun behaketa
Observaciones a Cocina|Sukaldaritza behaketak
Posicion|posizio
Escriba la nueva observacion|Idatzi behaketa berria
Eliminar Observación|Ezabatu behaketa
Seleccione Mesa Destino|Hautatu Destination Table
Total Cuenta Origen|Kontu osoaren jatorria
Seleccione Mesa A Juntar|Hautatu Taula Erregistratu
Seleccione Salon Destino|Aukeratu helmugako gela
Seleccione Salon|Hautatu Aretoa
Pedidos en Reserva|Erreserbako eskariak
Fecha Seleccionada|Hautatutako data
Total Reservas|Erreserbak guztira
Reservas Activas|Erreserbak aktiboak
N. Pedido|N. Orden
Fecha Entrega|Bidalketaren data
Hora Entrega|Entregatzeko ordua
Observaciones|nabarmentzea
Fecha de Entrega|Bidalketaren data
Hora de Entrega|Entregatzeko ordua
Contraseña = |Pasahitza =
Zona|zona
Venta Original|Salmenta originala
Total Cuenta Parcial|Kontu partzial osoa
Escriba la clave de gerencia|Sartu kudeaketa-tekla