Configuracion Inicial|Configuración inicial
Seleccione el Idioma / Select the Language|Seleccione Idioma / Seleccionar o idioma
Color|Cor
Movimiento|Movemento
Otros|Outros
Indiquenos desde que sitio ha descargado este programa|Indicar de que sitio descargaches este programa
Correo Electronico|Correo electrónico
2 decimales|2 decimais
0 decimales|0 decimais
Seleccione el Numero de Decimales|Seleccione o número de decimais
Seleccione el Impuesto|Selecciona o imposto
Seleccione su Bandera|Selecciona a túa Bandeira
Seleccione la Moneda|Selecciona a moeda
Seleccione el Pais|Selecciona o país
Nombre de Empresa|Nome da empresa
Continuar|Continuar
Programa|Programa
Continuar / Continue|Continuar / Continuar
Este boton le permitira cambiar la configuracion regional|Este botón permítelle cambiar a configuración rexional
Con este boton cambiara el tamaño de la ventana.|Con este botón, cambiará o tamaño da xanela.
Con este boton podra ver datos de su licencia|Con este botón podes ver os teus datos de licenza
Este boton le servira para cambiar el idioma|Este botón servirá para cambiar o idioma
Con este boton cambiara el color de la pantalla|Con este botón cambiará a cor da pantalla
Programa protegido por los derechos de propiedad intelectual en Marcas y Patentes en cuanto a contenido y diseño.|Programa protexido por dereitos de propiedade intelectual en marcas e patentes en termos de contido e deseño.
Madrid - España|Madrid - España
Tpv|Tpv
** Bienvenido **|** Benvido **
Salir|Saída
Caja Entradas|Caixa de entradas
Seleccione Su Opcion|Selecciona a túa opción
Caja Ropero|Caixa de armario
Comprar|Compra
¡Tiempo Limitado!|Tempo limitado
6 Comprados|6 Comprado
Horas:|Horas:
Cod Promocion: XXXXX|Promoción de bacallau: XXXXX
Tiene un descuento de|Ten un desconto
Precios|Prezos
* Recuerde que para poder tener asistencia telefonica tiene que tener contratado la version Completa, en caso contrario haga su consulta directamente desde el programa.|* Lembra que para ter asistencia telefónica debes ter a versión completa, se non, consulte directamente desde o programa.
* Consulte nuestra pagina web, para confirmar los precios que es posible que hayan sufrido algun cambio|* Consulte o noso sitio web, para confirmar os prezos que poden sufrir algún cambio
<Tipo de Licencia>|<Tipo de licenza>
Estoy utilizando una licencia|Estou usando unha licenza
Diferencias entre tipos de licencia|Diferenzas entre tipos de licenza
Pasar de la version Gratuita a la Basica|Cambia da versión gratuíta ao básica
Promociones / Envio Email|Promocións / Correo electrónico
Admisitracion Permisos|Permisos de admisión
Tipos de licencia|Tipos de licenza
Conectar en Red|Conectarse en rede
Activar Gratis la version Basica|Activa a versión básica de forma gratuita
Registrar|Rexistrarse
<Terminal>|<Terminal>
Acerca de|Acerca de
Asistencia|Asistencia
Configuracion|Configuración
Listados|Listados
Caja|Caixa
Conexion con dispositivo movil - android|Conexión co dispositivo móbil - Android
Niveles de Acceso|Niveis de acceso
Almacenes|Almacéns
Mantenimiento|Mantemento
Actualizaciones Activadas|Actualizacións activadas
Tpv 123 Hosteleria (Version: 8.5.1)|Tpv 123 Hosteleria (Versión: 8.5.1)
Serie: XXX|Serie: XXX
Licencia: XXX|Licenza: XXX
PROGRAMA REGISTRADO|PROGRAMA REGISTRADO
nombre restaurante|nome do restaurante
Tpv 123 Hosteleria|Tpv 123 Hospitalidade
ADVERTENCIAS IMPORTANTES|ADVERTENCIAS IMPORTANTES
- El desconocimiento de estas condiciones no le exime del cumplimiento de las mismas.|- A ignorancia destas condicións non lle exime a cumprir.
- Solo los clientes con la version COMPLETA tienen incluida la asistencia telefonica|- Só os clientes coa versión COMPLETA teñen asistencia telefónica incluída
---- En la modalidad COMPLETA, realizando un pago anual, ademas de las opciones incluidas en la version BASICA, tendra derecho a la asistencia de forma telefonica.|---- No modo COMPLETO, realizando un pagamento anual, ademais das opcións incluídas na versión BASIC, terás dereito a asistencia telefónica.
---- En la modalidad BASICA, con una reducida cuota anual usted tendra habilitada las opciones del programa que le permitiran realizar todas gestiones necesarias para su negocio, para mayor detalle recuerde consultar la opcion de Tipos de Licencia.|---- No modo BASICA, cunha tarifa anual reducida habilitarás as opcións do programa que che permitirán realizar todos os pasos necesarios para a túa empresa, para máis detalles recordade consultar a opción de Tipos de licenza.
Si decide utilizar la version GRATUITA recuerde que tiene algunas limitaciones, consulte la opcion de Tipos de Licencia para una descripcion mas detallada de la version GRATUITA, BASICA y COMPLETA.|Se decides usar a versión GRATUITA recorda que ten algunhas limitacións, consulta a opción de Tipos de licenza para obter unha descrición máis detallada da versión GRATUITA, BÁSICA e COMPLETA.
---- En la modalidad GRATUITA, durante los primeros 90 dias usted podra probar y trabajar con la version BASICA, pasado ese periodo podra volver a la version gratuita o pasar a la version BASICA o COMPLETA. Recuerde que esta version GRATUITA  es para empr|---- No modo GRATUITO, durante os primeiros 90 días podes probar e traballar coa versión BASIC, despois dese período podes volver á versión gratuita ou ir á versión BASIC ou COMPLETA. Lembre que esta versión gratuita é para o negocio
- La empresa Tpv 123 - Gratuito no es responsable si el cliente formatea el equipo o es atacado por algun tipo de virus que provoque la perdida de informacion o de licencia.|- A empresa Tpv 123 - Gratuito non se fai responsable se o cliente forma o equipo ou é atacado por algún tipo de virus que provoca a perda de información ou licenza.
- Tpv 123 - Gratuito recomienda la compra, para el buen funcionamiento del programa, de una impresora de tickets EPSON/SAMSUNG/Star o cualquier modelo de impresora, siempre que se instale junto con los drivers de dicha impresora. (Tipo de conexion recomen|- Tpv 123 - Free recomenda a compra, para o bo funcionamento do programa, dunha impresora de boleto EPSON / SAMSUNG / Star ou calquera modelo de impresora, sempre que se instale xunto cos controladores da impresora. (O tipo de conexión recoméndase
- Este es un programa estandar, no se hacen modificaciones a medida o personalizaciones, nuestros clientes en version BASICA y COMPLETA si pueden sugerirnos algunos cambios que nosotros sin ningun coste añadido incluiremos en siguientes versiones.|- Este é un programa estándar, non se realizan modificacións ou personalizacións personalizadas, os nosos clientes en BASIC e versión COMPLETA se poden suxerir algúns cambios que incluiremos sen custo adicional nas seguintes versións.
- Si usted esta utilizando la version GRATUITA y necesita algun tipo de asistencia recuerde que tiene que contratar la version BASICA o COMPLETA dependiendo de su incidencia.|- Se está a usar a versión GRATUITA e necesita axuda, lembre que ten que contraer a versión BASIC ou COMPLETE segundo a súa incidencia.
Al instalar este programa,usted acepta las siguientes condiciones:|Ao instalar este programa, aceptas as seguintes condicións:
CONDICIONES DE USO DEL PROGRAMA|CONDICIÓNS DE USO DO PROGRAMA
Promociones Fast Food|Promocións de comida rápida
Zonas|Áreas
SubFamilias|Subfamilias
Productos Elaborados|Produtos procesados
Productos|Produtos
Familias|Familias
Varios Precios|Varios prezos
Formas de Pago|Formas de pagamento
Empleados|Traballadores
Clientes|Clientes
Proveedores|Provedores
Aceptar|Aceptar
Cancelar|Cancelar
Eliminar|Eliminar
Modificar|Modificar
Nuevo|Novo
No Movimiento|Sen movemento
Productos relacionados con el proveedor:|Produtos relacionados co provedor:
Dia de Visita:|Visita o Día:
Número de Cuenta:|Número de conta:
Nombre del Banco|Nome do Banco
Dia de Pago:|Día de pagamento:
Forma de Pago:|Método de pagamento:
Observaciones:|Observacións:
Correo Electrónico:|Correo electrónico:
Móvil / Celular:|Móbil / celular:
Teléfono:|Teléfono:
Dirección:|Enderezo:
Población:|Poboación:
Código Postal:|Código postal:
Provincia:|Provincia:
País:|País:
DNI / CIF|DNI / CIF
Contacto:|Contacto:
Nombre|Nome
Gestion de Proveedores|Xestión de provedores
Lista de Proveedores|Lista de provedores
Ver Ingredientes|Vexa Ingredientes
Ver Productos Venta|Ver produtos Venda
Zona:|Zona:
    Buscar Por Nombre:|    Busca por nome:
Codigoproducto|Produto de código
Barra|Barra
Cocina|Cociñar
Ambos|Ambos
situaciongrid|situaciongrid
Posicion  en Pantalla:|Posición da pantalla:
Ingredientes|Ingredientes
Producto para Venta|Produto en venda
Mostrar en Pantalla de Caja:|Mostrar en caixa de pantalla:
Precio de Venta:|Prezo de venda:
Impuesto:|Imposto:
grid_ingredientes|grid_ingredientes
grid_productosventas|grid_productosventas
Descripcion Numerica:|Descrición numérica:
Seleccionar Color:|Seleccionar cor:
Insertar Imagen|Inserir imaxe
Tipo de Producto:|Tipo de produto:
Producto preparado en:|Produto preparado en:
Coste:|Custo:
Stock Actual:|Stock actual:
Stock Minimo:|Stock mínimo:
Proveedor:|Provedor:
Codigo de Barras:|Código de barras:
Unidades de medida:|Unidades de medida:
Nombre del Producto:|Nome do produto:
Gestion de Productos|Xestión de produtos
Buscar|Busca
Resultados de la Busqueda|Resultados da busca
panel de busqueda de clientes|panel de busca de clientes
Buscar Clientes|Buscar clientes
** DOBLE CLIC EN EL CLIENTE DESEADO|** DÚCELAR CLIC NO CLIENTE DESEADO
Rellene algun campo para la busqueda|Encha algúns campos para a busca
DNI/ CIF|DNI / CIF
Tlf Movil|Teléfono móbil
Telefono|Teléfono
Email|Correo electrónico
Provincia|Provincia
Poblacion|Poboación
Apellidos|Apelido
CP|CP
Codigo Cliente|Código de cliente
situacion|Situación
Descuento %|Desconto%
historico ventas|vendas históricas
datos|datos
Lista Ultimos 50 Clientes|Últimos 50 listados de clientes
Puerta|Porta
Numero|Número
Piso|Piso
Direcccion|Dirección
Nombre *|Nome *
situacion buscar|busca de situación
Gestion de Clientes|Xestión de clientes
Familia Tipo Menu Combo|Menú de tipo familiar Combo
Familia Tipo Menu|Menú de tipo familiar
Familia Generica|Familia xenérica
Gestion de Familias|Xestión familiar
Clic sobre la familia para ver mas detalles|Fai clic sobre a familia para ver máis detalles
Lista de Familias|Lista de familias
*Pulse en la familia para ver los productos agregados a la misma|* Fai clic na familia para ver os produtos engadidos nel
Seleccione el tipo de familia|Seleccione o tipo de familia
Lb_stopanelproductos|Lb_stopanelproductos
Esta familia no tiene productos relacionados|Esta familia non ten produtos relacionados
lista productos|produtos da lista
Clic en el producto que desee incluir en su familia|Fai clic no produto que desexas incluír na túa familia
Lista de Productos |Lista de produtos
Añadir Productos|Engadir produtos
Tipo de Familia:|Tipo de familia:
Label5|Etiqueta5
datos generica|datos xenéricos
datos familia generica|datos familiares xenéricos
Imagen|Imaxe
Datos de la Familia|Datos familiares
Mostrar en Caja |Mostrar en caixa
Posicion en Pantalla|Posición da pantalla
Descripcion Numerica|Descrición numérica
Productos Incluidos|Produtos incluídos
panel menu familia|familia do menú do panel
Producto incluido en otra familia|Produto incluído noutra familia
Productos Tercer Plato/ Postre|Terceiro produtos de prato / postre
Productos Segundo Plato|Produtos de segunda placa
Productos Primer Plato|Produtos de primeira placa
Añadir Postre|Engadir postre
Añadir Segundo|Engadir segundo
Añadir Primero|Engadir primeiro
Impuesto|Imposto
Precio de Venta|Prezo de venda
tipo|tipo
NO BORRAR|Non borras
situacion paneles|paneis de situación
Añadir + Productos a la SubFamilia|Engadir + produtos á subfamilia
Clic en el producto que desee incluir en el subproducto|Fai clic no produto que desexas incluír no subproduto
Familia a la que pertenece|Familia á que pertence
datos subfamilia|datos da subfamilia
Datos de la SubFamilia|Datos da subfamilia
SubFamilias Existentes|Subfamilias existentes
Num S.S.:|Num S.S .:
Repartidor:|Concesionario:
Apellidos:|Apelido:
Color en Caja:|Cor en caixa:
Número de  Cuenta:|Número de conta:
Nombre  del Banco:|Nome do banco:
Foto:|Foto:
Correo  Electrónico:|Correo electrónico:
NIF/ CIF:|NIF / CIF:
Nombre:|Nome:
Lista de Empleados|Listaxe de empregados
Gestion de Empleados|Xestión dos empregados
*clic para ver datos del producto|* fai clic para ver os datos do produto
top grid|grade superior
Sirve para que en lugar de que  aparezca una imagen en el boton  del producto aparezca un numero.|Serve para que no canto de aparecer unha imaxe no botón do produto, aparece un número.
alturacandidadingredientes|cadeas de altura
Es el lugar donde queremos que se  muestre el producto en caja cuando hacemos clic sobre su familia.|É o lugar onde queremos mostrar o produto na caixa cando facemos clic na súa familia.
nombreproducto|nome do produto
Codigo|Código
CantidaddeIngredientes|Cantidade de ingredientes
Cantidad|Cantidade
Ingredientes Incluidos en el Producto: |Ingredientes incluídos no produto:
Ver Datos Completos|Ver datos completos
¿cuantos|Cantos
sto ingredientes|ingredientes sto
Producto Elaborado|Produto procesado
Producto preparado en|Produto preparado en
Descripcion  Numerica:|Descrición numérica:
situacion izquierda|situación esquerda
situacion derecha|situación correcta
alturagrid|alturagrid
Seleccione el producto o el ingrediente a utilizar|Seleccione o produto ou ingrediente a empregar
Ver Productos|Ver produtos
Gestion de Productos Elaborados|Xestión de produtos procesados
Ver Ingredientes Incluidos|Vexa Ingredientes incluídos
Añadir Producto|Engadir produto
Nuevo Precio|Novo prezo
Precio Actual|Prezo actual
Añadir Nuevos Productos|Engadir novos produtos
Producto|Produto
Precio Original|Prezo orixinal
Precios Validos entre los siguientes dias y horas|Prezos válidos entre os días e horas seguintes
Hora Hasta|Hora Ata
Hora Desde|Tempo dende
Fecha Hasta|Data Ata
Fecha Desde|Data de
Nombre de la lista|Nome da lista
SITUACION DE LOS PANELES|SITUACIÓN DOS PANELES
Id lista|Lista de Id
Fecha de Alta|Data de rexistro
Desde|Desde
Hasta|Arriba
Horario Desde|Programar desde
Horario Hasta|Programar cara arriba
Ver Lista|Ver lista
Lista de Precios Existentes|Lista de prezos existentes
Volver Lista de Precios|Lista de prezos posteriores
Lista de Precios|Lista de prezos
Productos de Barra|Produtos de Barra
Productos de cocina|Produtos de cociña
Esta zona la voy a utilizar para|Vou usar esta área para
Zonas Existentes|Áreas existentes
Zonas de Impresion|Áreas de impresión
Diseño|Deseño
Otro Terminal|Outra terminal
Reservada|Reservado
Ocupada|Ocupado
Libre|Gratis
Panel Mesas|Táboas de paneis
Mesas|Táboas
Diseño Salon|Salon Design
Reservas|Reservas
Salones|Cuartos
Reserva|Reserva
Total|Total
Tablet Activada|Tablet activado
Visor Pedidos|Visor de ordes
Bit|Bit
Pedido Telefonico|Orde de teléfono
Envio|Envío
Juntar Cuentas|Únete a contas
SALON|SALON
EMPLEADO|EMPREGO
codigoempleado|código do empregado
PEDIDO|SOLICITUDE
H. INICIO|H. HOME
MESA|MESA
Cant.|Cant.
Precio|Prezo
Primero|En primeiro lugar
Segundo|Segunda
Postre|Sobremesa
Desc|Desc
Num_Factura|Num_Factura
Recargo|Recarga
Producto de Menu|Produto de menú
Menu|Menú
Codigo del Menu|Código de menú
Servido|Servido
Tipo de Impuesto|Tipo de imposto
Cod Empleado|Cod Employee
codigo Familia|Código familiar
Indice|Índice
Cod. Prod.|Cod. Prod.
Orden Menu|Menú de pedidos
ZonaImpresion|Área de impresión
BEBIDAS/ POSTRES|BEBIDAS / POSTRES
PRIMER PLATO|PRIMEIRA PLACA
SEGUNDO PLATO|SEGUNDA PLACA
situacion panel producto|situación do panel de produto
Opciones|Opcións
Cobrar|Carga
Abrir  Cajetin|Open Cajetin
Preticket|Preticket
Enviar a cocina|Enviar á cociña
Borrar Venta|Eliminar venda
Observ. Pedido|Observei Orde
Crear/Modificar Salones|Crear / Modificar cuartos
Diseño de Salones|Deseño de cuartos
Elementos para  el diseño|Elementos para o deseño
Posicion del objeto/mesa|Posición do obxecto / táboa
Eliminar Mesa|Eliminar a táboa
Eliminar Objeto|Eliminar obxecto
Guardar Numero|Gardar número
Numero Mesa|Táboa numerada
Eliminar Diseño Salon|Eliminar Salón de deseño
Boton Pulsado|Botón pulsado
Objeto Pulsado|Obxecto pulsado
Esta diseñando el:|Está a deseñar o:
Alta Salones/ Barra|Salas altas / Bar
Lista de Salones - Barras|Listado de cuartos - Bares
Recargo:|Recargo:
Posicion En Pantalla:|Posición da pantalla:
Color Salon|Salón de cor
Imagen Mesas|Mesas de imaxe
Nro de Mesas:|Nº de táboas:
Imagen Salon|Salon imaxe
Cambiar Idioma / Change Language|Cambiar o idioma / cambiar o idioma
Base De Datos|Base de datos
Contraseña Director|Contraseña do director
Importar Imagenes del Servidor|Importa imaxes do servidor
Permisos Usuario|Permisos de usuario
Importar Datos|Importar datos
Cierre Año|Ano próximo
Envio Informes|Informes de envío
Conexion en Red|Conexión de rede
Aumento Precio|Aumentar o prezo
Horario|Horario
Diseño Ticket / Factura|Deseño de billetes / Factura
Cajetin|Cajetin
Impresoras|Impresoras
Copia de Seguridad|Copia de respaldo
Configuracion Regional|Configuración rexional
Datos de la empresa|Datos da empresa
situacionpaneles|situacionpaneles
Esta a punto de restaurar una copia de seguridad, recuerde que este proceso es irreversible y cambiara la base de datos con la que trabaja en estos momentos por la seleccionada |Está a piques de restaurar unha copia de seguridade, lembre que este proceso é irreversible e cambiará a base de datos coa que está a traballar actualmente para o seleccionado.
Hacer Copia de Seguridad|Fai unha copia de seguranza
Restaurar Copia de Seguridad|Restaurar a copia de seguranza
Administracion Permisos|Administración de permisos
Nro. de copias del preticket|Nº de copias previas ao boleto
Nro. de copias del ticket|Nº de copias do billete
Centrado|Centrado
OFF|OFF
ON|ON
Enviar Confirmacion Reserva|Enviar reserva de confirmación
Enviar email al director / cierre caja|Envía un correo electrónico a caixa de director / pechar
Realizar cierre caja ciego|Realice a caixa de peche
Pedir Contraseña Al Entrar Al Programa|Solicitar contrasinal ao entrar no programa
Permisos Usuarios|Permisos dos usuarios
Pedir contraseña para las modificaciones / eliminaciones / descuentos ... (Para todos los empleados)|Solicitar contrasinal para modificacións / eliminacións / descontos ... (Para todos os empregados)
Pedir Contraseña Apertura de Cajetin|Solicitar Contrasinal Abrir Cajetin
Pedir Contraseña Al Entrar Caja|Solicitar contrasinal ao entrar no cadro
Pedir Empleado Al Entrar Caja|Pregunta ao empregado ao entrar na caixa
Activar Opciones|Activar Opcións
Pedir Contraseña|Solicitar contrasinal
Pedir Empleado X Cada Venta|Solicite empregado X cada venda
Utilizar Caja Rapida|Use a caixa rápida
Entrar en modo Direccion|Introduce o modo enderezo
¿Ha olvidado su contraseña?|Esqueceu o seu contrasinal?
No ha seleccionado ningun empleado|Non seleccionaches ningún empregado
Ingrese su clave:|Introduce o teu contrasinal:
SELECCIONE EL EMPLEADO|SELECCIONA O EMPREGO
Nombre de la Empresa|Nome da empresa
Ingrese el nro. de percha|Introduce o número de percha
lb-_Empleado|lb_empleador
Cambio Precio|Cambiar prezo
Cierre De Caja|Cierre de caixa
Imprimir Resguardo|Imprimir Resguardo
Imprimir Ticket|Ticket impreso
Abrir Cajetin|Open Cajetin
Terminar Venta|Finalizar a venda
Importe Total Prendas|Cantidade total de pezas
Entrega cliente|Entrega ao cliente
Devolucion|Retorno
Venta Anterior|Venda previa
Nro Prendas|Roupa n
Caja - Ropero|Caixa - Armario
Entrada Seleccionada|Entrada seleccionada
Entrada + consumicion|Entrada + consumo
Entrada Seleccionada:|Entrada seleccionada:
Seleccion De Entradas|Selección de billetes
Nombre del Visor:|Nome do espectador:
Utilizar Visor|Usar o visor
Eliminar Impresoras de este teminal|Elimina impresoras desde este terminal
La impresora se ha dado de alta correctamente|A impresora rexistrouse correctamente
Seleccione la celda en la interseccion de la impresora y la zona que quiere asociar|Seleccione a cela na intersección da impresora e na área que desexa asociar
Configuracion de Impresoras|Configuración da impresora
Gestion de Impresoras|Xestión da impresora
Reenvio de Pedidos A cocina / Barra|Envío de pedidos a cociña / bar
* click en la linea que desea reimprimir|* fai clic na liña que desexa reprint
Zona Impresion|Zona de impresión
Hora|Hora
numPedido|numPedido
Fecha|Data
enviado|enviado
Detalles del Pedido|Detalles da Orde
Reenviar|Reenviar
NumPedido =|OrderNum =
Guardar|Gardar
Descuento a aplicar|Desconto a aplicar
lblCliente|lblClient
Terminar Venta <F12>|Finalizar a venda <F12>
Descuento|Desconto
Buscar Cliente|Buscar cliente
Cambio|Cambio
Cliente entrega Efectivo|Cliente de entrega de efectivo
Cliente paga con Tarjeta|O cliente paga con tarxeta
Formato de Impresion|Formato de impresión
Formato A4|Formato A4
Formato A5|Formato A5
Tamaño 10 cm.|Tamaño 10 cm.
Imprimir factura|Imprimir factura
SubTotal|SubTotal
Propina|Consello
Enviar ticket Correo Electronico|Enviar correo electrónico de boleto
Cerrar Venta|Pechar venda
Imprimir en Cocina|Imprimir en cociña
V E R  T I C K E T|V E R T I C K E T
Tipo de venta|Tipo de venda
Factura|Factura
Boleta Formato Ticket|Ticket format de boleto
Ultima Venta|Última venda
Diseño de salon|Deseño de salón
Eliminar Venta Ya Cobrada|Eliminar a venda xa recompilada
Cobro Parcial|Colección parcial
Reservas de Mesas|Reservas de mesa
Listados Caja|Caixa de listados
Retirada de Caja|Retirada de diñeiro
Gastos del Dia|Gastos por día
Activar Precios para este Terminal|Activar os prezos para esta terminal
Reimpresion Ticket|Boleto de reimpressão
Modificacion de Tickets|Modificación de entradas
Conteo y cierre de caja|Contar e pechar o diñeiro
situacion panel opciones|opcións de situación do panel
panel_opciones de caja|Opcións do panel
CONFIGURACION OPCIONES CAJA|OPCIONES DE CAIXA DE CONFIGURACIÓN
Regresar al idioma original|Voltar ao idioma orixinal
¿Confirma que desea eliminar el siguiente registro?|Estás seguro de que queres eliminar o seguinte rexistro?
Idiomas|Linguas
Usted ha seleccionado|Seleccionaches
Ninguno|Nada
¿Seleccione el Idioma?|Selecciona o idioma?
Texto Traducido|Texto traducido
Texto Original|Texto orixinal
id|id
Texto|Texto
Traduccion|Tradución
lineas sin traducir|liñas non traducidas
Click sobre la linea para añadir una traduccion|Fai clic na liña para engadir unha tradución
Click sobre la linea para modificar la traduccion|Fai clic na liña para modificar a tradución
Texto sin traducir|Texto non traducido
Condiciones|Condicións
Registro de Licencias|Rexistro de licenzas
Acerca de ...|Sobre ...
TPV Gratuito|POS gratuíto
B. Aires - Argentina|B. Aires - Arxentina
D. F. - Mexico|D. F. - México
Santiago de Chile|Santiago, Chile
Lima - Peru|Lima - Perú
Costa Rica|Costa Rica
Puerto Rico|Porto Rico
Miami - Florida|Miami - Florida
Bogota - Colombia|Bogotá - Colombia
Mantenimiento registrado hasta:|Mantemento rexistrado ata:
Fecha de Caducidad:|Data de caducidade:
Fecha de Instalacion:|Data de instalación:
TPV Gratuito, Departamento de Desarrollo|POS gratuíto, Departamento de Desenvolvemento
Ultima actualizacion: XXX|Última actualización: XXX
Fecha de creacion:  XXX|Data de creación: XXX
Proyecto: Tpv 123, Version: XXX|Proxecto: Tpv 123, Versión: XXX
Paseo de Europa 7, (S.S. de los Reyes - Madrid -España)|Paseo de Europa 7, (S.S. de los Reyes - Madrid-España)
Buenos Aires - Argentina|Bos Aires - Arxentina
E-mail: compras@tpvgratuito.com   www.tpvgratuito.com|Correo electrónico: compras@tpvgratuito.com www.tpvgratuito.com
Servicio de asistencia:|Helpdesk:
Reg. Anual|Reg anual
Usted está utilizando una licencia:|Está a usar unha licenza:
SolverMedia|SolverMedia
SolverMedia, Departamento de Desarrollo|SolverMedia, Departamento de Desenvolvemento
Fecha de creacion: XXX|Data de creación: XXX
Proyecto: Servidor Net, Version: XXX|Proxecto: Servidor Net, Versión: XXX
No hay datos para ser mostrados|Non hai datos para mostrar
Listado de Empleados|Listaxe de empregados
Listado de Familias|Lista de familias
Listados Generales|Listaxes xerais
Ventas NCF Rep. Dominicana|Vendas NCF Rep. Dominicana
Ventas con Promociones|Vendas con promocións
Productos Bajo Minimo|Produtos Baixos Mínimos
Reimprimir Factura - Ticket|Reimpresión de facturas - Ticket
Ventas x Clientes|Vendas x Clientes
Imprimir Letreros  y  Etiquetas |Sinais e etiquetas de impresión
Estadisticas|Estatísticas
Valoracion Stock x Proveedores|Valuación Stock x Provedores
Valoracion Stock General|Valoración xeral de accións
Listado de Proveedores|Lista de provedores
Listado de Clientes|Lista de Clientes
Listado de Productos|Lista de produtos
Servicios a Domicilio|Servizos domésticos
Consumo de Platos Menu|Menú de consumo de pratos
Reservas x Dia|Reservas x Día
Pedidos Realizados a Proveedor|Pedidos feitos ao fornecedor
Empleado del Mes|Traballador do mes
Estadistica x Repartidor|Estatísticas x Revendedor
Retiradas Empleados|Empregados retirados
Relacion Envios Cocina contra Ventas|Envío Relación Cociña vs Vendas
Formato Din-A4|Formato Din-A4
Formato Ticket|Formato de boleto
Total Diario de Retiradas|Retirada diaria total
Ventas x Zonas|Vendas x Áreas
Caja Total x Dias|Caixa Total x días
Gastos de Caja|Gastos en efectivo
Descuentos Realizados|Descontos realizados
Ventas en el mes (Acumulado x Horas)|Vendas no mes (horas x acumuladas)
Reservas Hora/Dia /Mes|Reservas Hora / Día / Mes
Ventas x Empleados|Vendas x Empregados
Impuestos Repercutidos|Impostos tributais
Gastos|Gastos
Relacion de Propinas|Razón Tip
Ventas x Menus|Vendas x Menús
Resumen Contable de Facturas|Resumo de contabilidade de facturas
Productos mas Vendidos|A maioría dos produtos vendidos
Productos Sin Ventas|Produtos sen vendas
Ventas x Horas|Vendas x horas
Resumen de Venta x Empleados|Resumo de Venda x Empleados
Ventas Detalladas x Empleados|Vendas detalladas x Empregados
Ventas Eliminadas y Descuentos|Vendas e descontos eliminados
Ventas x Zonas -Totalizado x Productos|Vendas x Áreas -Totalizadas x produtos
Ventas Generales x Dia|Vendas xerais x Día
Ventas x Familias|Vendas x Familias
Ventas x Zonas Formato General|Vendas x Formato xeral de áreas
Ventas x Forma de Pago|Vendas x Forma de pagamento
Ventas Formato Ticket Resumido|Formato de venda de resumo
Ventas Formato Ticket x Empleado|Formato de venda Ticket x Empregado
Productos Bajo Minimos Formato Ticket|Produtos baixo Ticket Minimal Format
Ventas Eliminadas Formato Ticket|Boleto de venda de formatos eliminados
Cierres de Caja Formato Ticket|Formato de cupón de caixón
Ventas Formato Ticket Detallado|Formato de venda detallado de vendas
Subproductos|Subprodutos
Eliminar Datos de Prueba|Eliminar datos de proba
Configuracion Empresa|Configuración da empresa
Datos de la Factura|Datos da factura
Ultimo Nro. Utilizado = |Último usado Non =
Factura Numero|Número de factura
Numeracion de factura|Número de factura
No Incluidos|Non incluído
Incluidos|Incluído
Impuestos|Impostos
Ancho A5 (14cm)|Ancho A5 (14 cm)
Ancho 10 cm|Ancho 10 cm
Ancho A4 (21cm)|Ancho A4 (21 centímetros)
Formato de Factura|Formato de factura
Logo de la Empresa|Logotipo da empresa
Pagina Web|Sitio web
Direccion|Enderezo
Pais|País
Codigo Postal|Código postal
Detalles de la Empresa|Detalles da empresa
Recuerde que en la carpeta indicada en la linea superior tiene que existir el archivo nomprog.|Lembre que no cartafol indicado na liña superior hai que existir o ficheiro nomprog.
Paso1: Confirme que todos sus equipos esten conectados en red.  Paso2: De todos los equipos que tiene, tiene que seleccionar uno que va a hacer de servidor.  Paso3: El equipo que hara de servidor tiene que tener el disco C compartido y con los permiso|Paso 1: confirma que todas as computadoras están conectadas nunha rede. Paso 2: De todos os equipos que ten, tes que seleccionar un que vai ser un servidor. Paso 3: O equipo que fará que o servidor teña o disco C e co permiso compartido
Nota: Localice el equipo que hara de servidor que la base de datos la encontrara en |Nota: Localice a computadora que fará que o servidor atopalo na base de datos
Conectar con la base de datos|Conéctate coa base de datos
Como tiene que poner su equipo  en modo red local (varios equipos)|Como poñer o computador no modo de rede local (varias computadoras)
Conexion con otro Terminal|Conexión con outra terminal
Permisos de Usuario|Permisos de usuario
Seleccione el empleado al que va a configurar permisos|Seleccione o empregado ao que vai establecer permisos
Cambio Guardado|Cambio gardado
Cambio de Clave|Cambio de contrasinal
* Maximo 8 caracteres|* Máximo 8 caracteres
Confirmacion|Confirmación
Nueva|Novo
Antigua|Antiga
Cambiar Contraseña|Cambiar contrasinal
Cambios guardados|Cambios gardados
Aplicar Cambios para este Empleado|Aplique os cambios para este empregado
Borrar Restricciones|Eliminar restricións
Opciones configurables|Opcións configurables
NO Permite acceso al modulo|NO Permite o acceso ao módulo
Permite acceso al modulo|Permite o acceso ao módulo
Seleccione su pais|Selecciona o teu país
Nombre del Impuesto (IVA, IGIC, IGV, etc.)|Nome do Imposto (IVE, IGIC, IGV, etc.)
Si en su pais no se aplica esta normativa, NO ACTIVE esta opcion|Se esta regulación non se aplica no teu país, NO active esta opción
Si ACTIVA esta opcion, en las facturas el num. le aparecera asi: 000- 000-00-0000000X|Se activa esta opción, nas facturas o num. aparecerá así: 000-000-00-0000000X
En algunos paises la normativa indica que el numero de facturas tiene que ir precedido por una serie de identificadores.|Nalgúns países, as normativas indican que o número de facturas debe ir precedido dunha serie de identificadores.
INFORMACION SOBRE FACTURAS ESPECIALES|INFORMACIÓN SOBRE FACTURAS ESPECIAIS
Moneda|Moeda
Simbolo Moneda|Símbolo de moeda
Formato Hora:|Formato de tempo:
Numero de decimales ( 0,1,2)|Número de decimais (0,1,2)
Identificacion Fiscal (Cif, Nif, Ruc, Rut, Rnc, etc.)|Identificación fiscal (Cif, Nif, Ruc, Rut, Rnc, etc.)
h=12 Horas (AM o PM)|h = 12 horas (AM ou PM)
h=24 Horas |h = 24 horas
Otra Moneda|Outra moeda
Btc 1 BitCoin = |Btc 1 BitCoin =
€ 1 Euro = |€ 1 euro =
$ 1 Dolar = |$ 1 Dólar =
Hasta 8 decimales|Ata 8 decimais
Numero de credito fiscal|Número de crédito fiscal
Activar linea propina en preticket|Activar a liña de punta na versión previa
Guardar Cambios|Gardar cambios
Ingrese el concepto|Introduza o concepto
Activar concepto Propina / Servicio / Otros|Activar o concepto de Propagación / Servizo / Outro
(Opcion utilizada con frecuencia en algunos paises del caribe y sudameria) / No activar en paises en los que no es obligatorio cobrar propina|(Opción usada con frecuencia nalgúns países do Caribe e Sudamérica) / Non se active en países onde non é obrigatorio cargar consellos
Secuencia de Apertura|Apertura de secuencia
Para impresoras conexion paralela:|Para impresoras de conexión paralelas:
Probar / Guardar|Probar / gardar
* Click para seleccionar la secuencia de apertura|* Faga clic para seleccionar a secuencia de apertura
Marca de Impresora|Marca da impresora
Modelo de Impresora|Modelo da impresora
Otras secuencias de apertura|Outras secuencias de apertura
Nota: Es posible que la impresora realice el corte sin tener que añadir ninguna secuencia de apertura, en ese caso no hace falta que configure esta opcion|Nota: É posible que a impresora tome o corte sen ter que engadir ningunha secuencia de apertura, nese caso non necesitará configurar esta opción
* Click para seleccionar la secuencia de corte|* Faga clic para seleccionar a secuencia de corte
Secuencia de Corte|Secuencia de corte
Otras secuencias de Corte de Papel|Outras secuencias de corte de papel
Configuracion de corte automatico al final del ticket:|Configuración automática de corte ao final do billete:
¿Que son comandos adicionales? Despues de instalar los drivers de la impresora en propiedades de la misma encontramos una pestaña de comandos adicionales / desde aqui marcaremos la opcion de apertura de cajon (Open Draw1 o Open Draw2).|Cales son os comandos adicionais? Despois de instalar os controladores da impresora nas propiedades do mesmo, atope unha lapela de comandos adicionais / desde aquí marquemos a opción de abrir o caixón (Open Draw1 ou Open Draw2).
Apertura estandar para impresoras USB|Apertura estándar para impresoras USB
Para impresoras con comandos adicionales: (serie, paralelo, usb)|Para impresoras con comandos adicionais: (serie, paralelo, usb)
Para impresoras salida serie:|Para impresoras de saída en serie:
Configuracion de Apertura de Cajon|Configuración de Apertura do Cajón
Si conoce que tipo de conexion tiene su impresora de tickets seleccione la que le corresponde en caso contrario pruebe cada uno de ellos hasta confirmar cual es el que abre.|Se coñece o tipo de conexión que ten a súa impresora de boleto, seleccione o que lle corresponde, probe con cada un deles ata que confirme que se abre.
Ayuda|Axuda
Configuracion de Cajetin|Configuración do boletín
Courier New|Mensaxeiro Novo
Seleccione Tamaño Letra: Cuerpo|Seleccionar tamaño da letra: corpo
Seleccione Tamaño Letra: Titulo|Seleccione Carta Tamaño: título
Seleccione Tipo Letra|Seleccione Carta de tipo
Tipo / Tamaño Letra|Carta de tipo / tamaño
Nro. de Decimales que quiero utilizar|Número de decimais que quero usar
Mi impresora imprime|A miña impresora imprime
Nro. de caracteres de su impresora|Número de caracteres da impresora
caracteres por linea|caracteres por liña
Poblacion:|Poboación:
Direccion:|Enderezo:
Tel:|Tel:
CIF / DNI:|CIF / DNI:
Cliente:|Cliente:
Empleado:|Empregado:
Fact. Simpli:|Feito. Simples:
Codigo Barras|Código de barras
Lineas en blanco al final del ticket = |Liñas en branco ao final do billete =
Escriba aqui su comentario del final de ticket|Escribe aquí o teu comentario do billete
** Gracias por su visita **|** Grazas pola túa visita **
Impuestos Incluidos|Impostos incluídos
Varias lineas para descripcion del producto|Varias liñas para a descrición do produto
Añadir codigo de barras en descripcion de producto|Engadir código de barras na descrición do produto
Otras Opciones|Outras opcións
Mostrar P. Unitario|Mostrar P. Unitario
Desglose Impuesto|Taxa tributaria
Total en Letras|Total en cartas
Utilizar SubTotal|Usar SubTotal
Cuota|Tarifa
Base|Base
Tipo IVA|Tipo de IVE
Entrega|Entrega
P. U.|P. U.
Descripcion|Descrición
Uds|Ti
WEB|WEB
Puede cambiar|Podes cambiar
CIF|CIF
Nombre Empresa|Nome da empresa
Imagen al Principio|Imaxe no comezo
Datos de Cabecera|Datos de cabeceira
Clic para cambiar Imagen|Fai clic para cambiar a imaxe
Nro Venta/Pie de Ticket|Sen venda / pés de billete
Diseño Ticket|Deseño de billetes
Valor de venta en letras|Valor de venda en letras
Diseño de Ticket|Deseño de billetes
Pie de Ticket|Pase de billetes
Detalles del  Ticket|Detalles do boleto
Vista Previa|Vista previa
Cabecera  Ticket|Cabeceira de billetes
Datos del  Cliente|Datos do cliente
Clave:|Contrasinal:
Usuario: Director|Usuario: Director
Está a punto de realizar la restauración de sus copias de seguridad de sus bases de datos.  Para ello deberá localizar su copia de seguridad en su disco duro o en su modulo de memoria extraible.  Dicha operación demorará unos segundos, una vez finaliz|Estás a piques de restaurar as túas copias de seguridade das túas bases de datos. Para iso debes atopar a túa copia de seguridade no disco ríxido ou o módulo de memoria extraíble. Dita operación levará uns segundos, unha vez que remate
TPV Hosteleria|POS Terminal Hosteleria
Grafica de Envios|Gráficos de envío
Relacion Emails Enviados|Relación de correos electrónicos enviados
Envio Promocion|Promoción do envío
Crear Plantillas Reservas|Crea Reservas de Modelos
Envio Puntual|Envío oportuno
Crear Plantillas|Crear modelos
Activar Servicio De Correos|Activar o servizo de publicación
Enviados:|Enviado:
Label6|Etiqueta6
Saldo:|Balance:
Su ID Es|A túa identidade é
Servicio Correo|Servizo de correo
Le hemos asignado  20 correos gratis|Nós asignámoslle 20 correos electrónicos gratuítos
Su registro se ha realizado con exito|O seu rexistro completouse con éxito
Nombre de Usuario|Nome de usuario
Correo de Contacto|Correo electrónico de contacto
Incluir Logo|Incluír o logotipo
Pie de Correo|Correo a pé
Configuracion Correo|Configuración de correo
Mensaje Enviado|Mensaxe enviada
Enviar|Enviar
Envio Puntual de Correo|Envío de correo
toolStrip1|toolStrip1
Mensaje|Mensaxe
Remitente|Remitente
Asunto|Asunto
Destinatario|Destinatario
Seleccione el intervalo de fechas|Seleccione o intervalo de datas
Chart1|Gráfico1
Grafico|Gráfico
Nueva Plantilla|Nova modelo
Plantillas Promociones|Plantillas de promocións
Guardado Correctamente|Gardado correctamente
No|Non
Sí|Si
¿Desea cargar el diseño anterior?|Desexa cargar o proxecto anterior?
Nombre Plantilla|Nome do modelo
Plantilla 3|Modelo 3
Plantilla 2|Modelo 2
Plantilla 1|Modelo 1
Plantilla|Modelo
<---- Texto que aparece en el cuerpo de la promocion|<---- Texto que aparece no corpo da promoción
<---- Escriba el  texto que desea que aparezca en la parte inferior de la promocion|<---- Escribe o texto que queres que apareza na parte inferior da promoción
<---- Escriba el titulo o el texto que desea que aparezca en la cabecera de la promocion|<---- Escribe o título ou o texto que queres que apareza no encabezado da promoción
Pie de página|Pé de páxina
Titulo|Título
<---- Haga un click para insertar la imagen|<---- Prema para inserir a imaxe
Plantilla Guardada|Plantilla gardada
Cuerpo del Mensaje|Corpo da mensaxe
Plantilla Reservas|Reservas de modelos
<---- Texto que se genera automaticamente|<---- Texto que se xera automaticamente
<---- Escriba el  texto que desea que aparezca en la parte inferior de la reserva|<---- Escriba o texto que desexa que apareza na parte inferior da reserva
<---- Escriba el titulo o el texto que desea que aparezca en la cabecera de la reserva|<---- Escriba o título ou o texto que desexa que apareza no encabezado de reserva
Configurar Email|Configurar o correo electrónico
Mostrar clientes|Amosar clientes
Filtrar Clientes para Enviar Email|Clientes de filtro para enviar correo electrónico
Seleccione una opcion|Selecciona unha opción
Menor que|Menos que
Mayor que|Maior que
Consumo|Consumo
Ingrese un codigo postal|Introduce un código postal
Todos los clientes|Todos os clientes
Num. Visita|Número de visita
Cumpleaños|Aniversario
Enviando Emails|Envío de correos electrónicos
Cerrar|Pechar
Ctrl+C para copiar los correos de esta lista para hacer un envio desde la aplicacion de correo electronico (gmail, hotmail, etc...) que desee.|Ctrl + C para copiar os correos desde esta lista para facer un envío dunha aplicación de correo electrónico (Gmail, Hotmail, etc ...) que quere.
Lista de correos seleccionados|Lista de correos electrónicos seleccionados
Enviar Email a Clientes Seleccionados|Enviar correo electrónico a clientes seleccionados
Lista de clientes|Lista de clientes
 Mostrar Todos| Mostrar todo
Emails Seleccionados|Correos electrónicos seleccionados
Marcar Todos|Marcar todo
Copiar Emails seleccionados  para envio manual|Copia os correos electrónicos seleccionados para a entrega manual
 Mostrar solo con Email Valido| Amosar só co correo electrónico válido
Clientes Seleccionados|Clientes seleccionados
Cantidad de clientes que cumplen las condiciones|Número de clientes que cumpren as condicións
Importe|Cantidade
Visitas|Visitas
* Si no pone un correo electronico valido no recibirá respuesta|* Se non pon un correo electrónico válido, non recibirá unha resposta
Telefono:|Teléfono:
Email: *|Correo electrónico: *
Ingrese sus datos para poder responderle|Introduce a túa información para poder responder
Formule su Consulta|Fai a túa pregunta
Aviso de averia|Aviso de desglose
Pregunta o Consulta|Pregunta ou consulta
Tipo de Consulta|Tipo de consulta
Si tiene alguna Incidencia / Pregunta sobre nuestro programa utilice esta opcion siguiendo los pasos:|Se ten algunha Incidência / Pregunta sobre o noso programa, use esta opción seguindo os pasos seguintes:
Aviso de Averia / Consulta|Aviso / consulta
Asistencia y Sugerencias|Asistencia e suxestións
Si no tiene contratado este servicio nuestra empresa no tiene la obligacion de dar ningun tipo de servicio o ser responsable de algun cambio de su sistema informatico.|Se non ten este servizo contratado, a nosa empresa non ten a obriga de prestar ningún tipo de servizo nin ser responsable por ningún cambio no seu sistema informático.
Si la compra de este producto ha superado el año y tiene caducado la asistencia / actualizaciones del programa, y tiene un problema recuerde, primero contratar nuestro servicio de asistencia para una solucion adecuada.|Se a compra deste produto superou o ano e a axuda / actualizacións do programa caducou e tes un problema lembrar, primeiro contrate o noso servizo de asistencia para unha solución adecuada.
Cambio de equipo informatico, cambio de disco duro, formateo de disco duro, etc...|Cambio de equipos informáticos, cambio de disco duro, formato de disco duro, etc.
4.- Estimado cliente recuerde que sólo podrá recibir las actualizaciones del programa en caso de tener el contrato de mantenimiento al día.|4.- Estimado cliente: recordade que só pode recibir actualizacións do programa se ten o contrato de mantemento actualizado.
3.- Si se produce alguno de estos casos anteriores, antes de realizar ninguna acción,  pongase en contacto con el departamento técnico de SolverMedia comercial@solvermedia.com para que le ayuden a realizar el cambio.|3.- Se ocorre algún destes casos anteriores, antes de realizar calquera acción, contacte ao departamento técnico de SolverMedia comercial@solvermedia.com para axudarche a facer o cambio.
2.- La empresa SolverMedia no concederá una nueva licencia a aquellos clientes que por problemas ajenos a SolverMedia hallan perdido el registro del programa, esos problemas pueden venir causados por:|2.- A empresa SolverMedia non concederá unha nova licenza a aqueles clientes que, debido a problemas externos a SolverMedia, perderon o rexistro do programa, estes problemas poden ser causados ​​por:
1.- La empresa SolverMedia no se responsabiliza de la mala manipulación de su registro de licencia así como del numero asignado para su registro.|1.- A empresa SolverMedia non se fai responsable da mala manipulación do seu rexistro de licenza, así como do número asignado para a súa inscrición.
La contraseña de direccion es: |O contrasinal da dirección é:
Maximo 8 caracteres|Máximo 8 caracteres
Confirme la contraseña|Confirma o contrasinal
Ingrese la contraseña nueva|Introduce o novo contrasinal
Ingrese la contraseña anterior|Introduce o contrasinal anterior
Recordatorio de contraseña de direccion|Recordatorio de contrasinal de enderezo
Cambio de contraseña de direccion|Cambio de contrasinal de enderezo
Volver a intentar|Téntao de novo
Las respuestas introducidas no son correctas|As respostas ingresadas non son correctas
Para poder recordarle la contraseña de direccion es necesario que responda a las siguientes preguntas|Para poder lembra-lo contrasinal do enderezo tes que responder ás seguintes preguntas
Año|Ano
Mes|Mes
Dia|Día
Ingrese el segundo apellido de su madre|Introduce o segundo apelido da túa nai
Indique su fecha de nacimiento|Indique a súa data de nacemento
Si olvida la contraseña que acaba de introducir podra recuperarla respondiendo a las preguntas anteriores.|Se esquece o contrasinal que acaba de ingresar, pode recuperalo respondendo as preguntas anteriores.
La contraseña y las respuestas de recordatorio se han guardado correctamente.|As respostas de contrasinal e recordatorio foron gardadas correctamente.
Boletas|Boletas
Facturas|Facturas
codCliente|codClient
Cliente|Cliente
F.Pago|F. Pagamento
** clic en la lista o introduzca el numero de ticket|** Fai clic na lista ou introduce o número do billete
Ingrese el numero de ticket / factura|Introduce o número / factura do billete
Lista de las ultimas ventas|Lista das últimas vendas
Concepto del gasto|Concepto de gasto
Gastos Del Día|Gastos por día
Ultimos 50 gastos (clic para modificar)|Últimos 50 gastos (faga clic para modificar)
ESPACIO|ESPAZO
BORRAR|Eliminar
Deja en Caja :|Deixar en caixa:
Cerrar Ventas/Imprimir|Pechar vendas / imprimir
Observaciones de caja:|Observacións de efectivo:
Suma/Conteo de caja del turno actual|Suma / reconto de caso de cambio actual
Seleccione las monedas de su pais|Selecciona as moedas do teu país
Cargar monedas de la Zona Euro|Carga moedas da Eurozona
Valor n|Valor n
Terminal = XXX|Terminal = XXX
Total monedas|Moedas totais
Total tarjetas|Tarxetas totais
Total otras formas de pago|Total outros métodos de pago
Caja Inicial:|Efectivo inicial:
Num total de operaciones de este terminal|Número total de operacións deste terminal
Num total operaciones otras formas pago|Número de operacións totais outras formas de pago
Num total operaciones tarjeta|Operacións totais de tarxetas
Num total operaciones contado|Operacións totais contadas
Max. 20|Máx. 20
Número de tipos de moneda a utilizar:|Número de tipos de moeda a empregar:
Seleccione las monedas en circulacion de su pais|Selecciona as moedas en circulación do teu país
Tipo 20|Tipo 20
Nota: Esta opcion solo esta pensado para aquellos clientes que en su pais el valor de sus monedas es diferente al establecido para la zona Euro.|Nota: Esta opción só está destinada a aqueles clientes que no seu país o valor das súas moedas é diferente do establecido na zona euro.
Importe a Retirar|Importe para retirar
Retiradas|Retirada
TELEF|TELEF
Borrando|Borrado
Hora Reserva|Tempo de reserva
Nro comensales|Sen comensais
Todos|Todo
Cena|Cea
Almuerzo|Xantar
Desayuno|Almorzo
MESAS =|TABLES =
H O R A S|H O R A S
Seleccione Horario|Seleccionar horario
*Clic para seleccionar salon|* Fai clic para seleccionar a sala
R e s e r v a s|R e s e r v a s
Diseñar Plantilla reserva|Libro de modelos de deseño
Nueva Reserva|Nova reserva
Hora de Reserva|Tempo de reserva
Nro de Comensales|Número de comensais
Teléfono|Teléfono
* Click en la columna de telefono para ver la direccion|* Fai clic na columna de teléfono para ver a dirección
Resultado de la Búsqueda|Resultado da busca
Movil|Móbil
C. Postal|C. Postal
Limpiar|Limpo
DNI|ID
Puerta:|Porta:
Fijo / Movil|Fixed / Mobile
Piso:|Piso:
C. Postal:|C. Postal:
Número:|Número:
Email:|Correo electrónico:
Modificar Datos|Modificar datos
Nuevo Cliente|Novo cliente
Activar Precios para este terminal de venta|Activar os prezos deste terminal de vendas
Crear nueva o modificar una lista de precios existente|Crea novo ou modifica unha lista de prezos existente
Listas de Precios|Listas de prezos
Listas activa en este terminal|Listas activas neste terminal
Listas de precios no activa|Listas de prezos non activas
La lista de precios que ha seleccionado esta fuera del rango actual|A lista de prezos que seleccionaches está fóra do alcance actual
Nombre (click para seleccionar/desactivar)|Nome (fai clic para seleccionar / desactivar)
activa|activo
Fecha Alta|Data alta
Prod. en Lista|Prod. Na lista
Codigo Precio|Código de prezo
C. P.|C. P.
Cif / Dni|CIF / Dni
Realizando cambios|Facer cambios
alturapanel|alturapanel
Los mismos pasos 1, 2 para margen comercial o precio de venta.|Os mesmos pasos 1, 2 para marxe comercial ou prezo de venda.
* Clic sobre el impuesto que desea cambiar|* Fai clic sobre o imposto que queres cambiar
De:|De:
Cambio el valor de los impuestos|Cambia o valor dos impostos
Deseo cambiar|Quero cambiar
a:|a:
Nro. de Productos|Nº de produtos
2.-Luego seleccione el proveedor o seleccione la opcion todos.|2.-A continuación, seleccione o provedor ou seleccione a opción todos.
Con redondeo|Con redondeo
Sin redondeo|Sen redondeo
Todos los productos|Todos os produtos
Productos del Proveedor|Produtos do Provedor
Coste|Custo
Cambio de Coste / Precio|Cambio de custo / prezo
1.-Si desea aumentar el coste, solo debe ingresar el porcentaje en la caja del mismo.|1.- Se queres aumentar o custo, introduce a porcentaxe na caixa.
Recuerde que este proceso es irreversible. Confirme y  verifique los porcentajes que está aumentando.|Lembre que este proceso é irreversible. Confirma e verifica as porcentaxes que están a aumentar.
Este proceso automatiza el aumento de precio, margen comercial y coste de los productos.|Este proceso automatiza o aumento do prezo, marxe comercial e custo dos produtos.
Aumento de Precios|Aumento de prezos
Nombre Servidor SQL Server|Nome do servidor SQL Server
Utilizar  SQL   Server . . . . . |Use SQL Server . . . .
UTILIZAR SQL SERVER|USE SQL SERVER
Más Información|Máis información
Dirigido para aquellas empresas con volumenes de datos altos o muchas interacciones simultaneas soporta varios PC conectados en red sin problemas de concurrencias y trafico de datos. (si este es su caso nuestro programa funciona perfectamente con este ges|Dirixido a aquelas empresas con altos volumes de datos ou moitas interaccións simultáneas, soportan varias computadoras en rede sen problemas de concurrencia e tráfico de datos. (Se este é o teu caso, o noso programa funciona perfectamente con este
SQL SERVER|Servidor SQL
Indicado para empresas con volumen de datos bajos 1 o 2 PC en red.|Indicado para empresas con baixo volume de datos de 1 ou 2 PC en rede.
ACCESS|ACCESO
El Tipo de Base De Datos Que Su Negocio Necesita|O tipo de base de datos das súas necesidades comerciais
Pasar a la version Basica o Completa|Vaia á versión básica ou completa
Configure los Horarios de su establecimiento|Configurar os horarios do seu establecemento
Label2|Etiqueta2
a |a
El Horario del Establecimiento es:|O horario de establecemento é:
El Horario de Cocina es:|A horta de cociña é:
Seleccione el Horario del Establecimiento|Selecciona o horario de establecemento
Seleccione el Horario de Cocina|Selecciona o horario de cociña
4.- Solo le recomendamos que contrate este servicio y utilice esta opcion si solo si su empresa verdaderamente lo necesita, por nuestra experiencia el 90% de los usuarios de Puntos de Venta del sector retail no necesitan tener esta base de datos instalada|4.- Só recomendamos contratar este servizo e usar esta opción se só se a túa empresa o necesita de verdade, da nosa experiencia o 90% dos usuarios de Puntos de Venda no sector de venda polo miúdo non necesitan ter esta base de datos instalada
3.- Tiene que indicarnos los nombre de los usuarios que utilizaran el programa para crear los usuarios en la base de datos. (este servicio incluye 3 usuarios si desea mas usuarios el coste es de 5 Euros por cada uno)|3.- Debes indicar os nomes dos usuarios que usarán o programa para crear os usuarios na base de datos. (este servizo inclúe 3 ​​usuarios se desexa máis usuarios o custo é de 5 euros cada un)
2.- Tiene que tener instalado el TeamViewer para que un tecnico pueda conectar a instalar la BD y dejarle el programa funcionando en Sql Server|2.- Debe ter o TeamViewer instalado para que un técnico poida conectarse para instalar o BD e deixar o programa en execución en Sql Server
1.- Este servicio tiene un coste de 75 Euros + Iva|1.- Este servizo ten un custo de 75 euros + IVE
Si desea utilizar el programa con Sql Server un tecnico de nuestra empresa se lo puede instalar. Pasos que tiene que tomar en cuenta.|Se queres usar o programa con Sql Server, un técnico da nosa empresa pode instalalo. Pasos que debes ter en conta.
Requisitos Para Usar Sql Server|Requisitos para usar o servidor SQL
Numero de Ventas Menores A: |Número de vendas menores A:
Seleccione de que terminal quiere obtener la información|Seleccione a partir do terminal onde desexa obter a información
Servicios|Servizos
Completo|Completa
Total General|Total xeral
Total Gastos|Gastos totais
C. Inicial|C. Inicial
Total Retiradas|Retirada total
Totalizado por Forma de Pago|Totalizado mediante Formulario de pagamento
Ventas Generales por Dia|Vendas xerais por día
Esta Forma de Pago es de tipo Tarjeta|Este método de pagamento é tipo de tarxeta
Nueva Observación|Nova observación
comensal|comensal
Observacion|Observación
estado|estado
idenvio|idenvio
Seleccione la observacion que desea eliminar del panel de arriba|Selecciona a observación que queres eliminar do panel anterior
Observaciones a Cocina|Observacións á cociña
Posicion|Posición
Escriba la nueva observacion|Escribe a nova observación
Eliminar Observación|Eliminar a observación
Seleccione Mesa Destino|Seleccionar a táboa de destino
Total Cuenta Origen|Total da orixe da conta
Seleccione Mesa A Juntar|Seleccione a táboa para unirse
Seleccione Salon Destino|Seleccione Salon de destino
Seleccione Salon|Seleccionar salón
Pedidos en Reserva|Pedidos en Reserva
Fecha Seleccionada|Data seleccionada
Total Reservas|Reservas totais
Reservas Activas|Reservas activas
N. Pedido|Orde N.
Fecha Entrega|Data de entrega
Hora Entrega|Prazo de entrega
Observaciones|Observacións
Fecha de Entrega|Data de entrega
Hora de Entrega|Prazo de entrega
Contraseña = |Contrasinal =
Zona|Zona
Venta Original|Venda orixinal
Total Cuenta Parcial|Conta parcial total
Escriba la clave de gerencia|Introduce a clave de xestión