Configuracion Inicial|Configurazione iniziale
Seleccione el Idioma / Select the Language|Seleziona lingua / Seleziona lingua
Color|colore
Movimiento|mozione
Otros|altrui
Indiquenos desde que sitio ha descargado este programa|Indica da quale sito hai scaricato questo programma
Correo Electronico|posta elettronica
2 decimales|2 decimali
0 decimales|0 decimali
Seleccione el Numero de Decimales|Seleziona il numero di decimali
Seleccione el Impuesto|Seleziona la tassa
Seleccione su Bandera|Seleziona la tua bandiera
Seleccione la Moneda|Seleziona la valuta
Seleccione el Pais|Seleziona il paese
Nombre de Empresa|Nome dell'azienda
Continuar|continuare
Programa|programma
Continuar / Continue|Continua / Continua
Este boton le permitira cambiar la configuracion regional|Questo pulsante ti consentirà di modificare le impostazioni regionali
Con este boton cambiara el tamaño de la ventana.|Con questo pulsante, cambierai la dimensione della finestra.
Con este boton podra ver datos de su licencia|Con questo pulsante puoi vedere i tuoi dati di licenza
Este boton le servira para cambiar el idioma|Questo pulsante servirà per cambiare la lingua
Con este boton cambiara el color de la pantalla|Con questo pulsante il colore dello schermo cambierà
Programa protegido por los derechos de propiedad intelectual en Marcas y Patentes en cuanto a contenido y diseño.|Programma protetto da diritti di proprietà intellettuale in marchi e brevetti in termini di contenuto e design.
Madrid - España|Madrid - Spagna
Tpv|TPV
** Bienvenido **|** Benvenuto **
Salir|uscita
Caja Entradas|Scatola dei biglietti
Seleccione Su Opcion|Seleziona la tua opzione
Caja Ropero|Scatola guardaroba
Comprar|acquistare
¡Tiempo Limitado!|Tempo limitato!
6 Comprados|6 comprato
Horas:|ore:
Cod Promocion: XXXXX|Promozione del merluzzo: XXXXX
Tiene un descuento de|Ha uno sconto di
Precios|prezzi
* Recuerde que para poder tener asistencia telefonica tiene que tener contratado la version Completa, en caso contrario haga su consulta directamente desde el programa.|* Ricorda che per avere assistenza telefonica devi avere la versione completa, altrimenti consultare direttamente dal programma.
* Consulte nuestra pagina web, para confirmar los precios que es posible que hayan sufrido algun cambio|* Controlla il nostro sito Web, per confermare i prezzi che potrebbero aver subito qualche cambiamento
<Tipo de Licencia>|<Tipo di licenza>
Estoy utilizando una licencia|Sto usando una licenza
Diferencias entre tipos de licencia|Differenze tra i tipi di licenza
Pasar de la version Gratuita a la Basica|Passa dalla versione gratuita alla versione base
Promociones / Envio Email|Promozioni / Email
Admisitracion Permisos|Permessi di ammissione
Tipos de licencia|Tipi di licenza
Conectar en Red|Connetti in rete
Activar Gratis la version Basica|Attiva la versione base gratuitamente
Registrar|record
<Terminal>|<Terminal>
Acerca de|su
Asistencia|assistenza
Configuracion|Configuración
Listados|annunci
Caja|scatola
Conexion con dispositivo movil - android|Connessione con dispositivo mobile - Android
Niveles de Acceso|Livelli di accesso
Almacenes|magazzini
Mantenimiento|manutenzione
Actualizaciones Activadas|Aggiornamenti attivati
Tpv 123 Hosteleria (Version: 8.5.1)|Tpv 123 Hosteleria (Versione: 8.5.1)
Serie: XXX|Serie: XXX
Licencia: XXX|Licenza: XXX
PROGRAMA REGISTRADO|PROGRAMMA REGISTRATO
nombre restaurante|nome del ristorante
Tpv 123 Hosteleria|Tpv 123 Hospitality
ADVERTENCIAS IMPORTANTES|AVVERTENZE IMPORTANTI
- El desconocimiento de estas condiciones no le exime del cumplimiento de las mismas.|- L'ignoranza di queste condizioni non ti esonera dal rispettarle.
- Solo los clientes con la version COMPLETA tienen incluida la asistencia telefonica|- Solo i clienti con la versione COMPLETA hanno l'assistenza telefonica inclusa
---- En la modalidad COMPLETA, realizando un pago anual, ademas de las opciones incluidas en la version BASICA, tendra derecho a la asistencia de forma telefonica.|---- Nella modalità COMPLETA, effettuando un pagamento annuale, oltre alle opzioni incluse nella versione BASIC, avrai diritto all'assistenza telefonica.
---- En la modalidad BASICA, con una reducida cuota anual usted tendra habilitada las opciones del programa que le permitiran realizar todas gestiones necesarias para su negocio, para mayor detalle recuerde consultar la opcion de Tipos de Licencia.|---- Nella modalità di base, con un diritto annuale ridotto avrete attivato le opzioni del programma che vi permetterà di fare tutte le disposizioni necessarie per il vostro business, per maggiori dettagli vedere l'opzione ricordare tipi di licenza.
Si decide utilizar la version GRATUITA recuerde que tiene algunas limitaciones, consulte la opcion de Tipos de Licencia para una descripcion mas detallada de la version GRATUITA, BASICA y COMPLETA.|Se decidi di utilizzare la versione GRATUITA, ricorda che ha alcune limitazioni, consulta l'opzione Tipi di licenza per una descrizione più dettagliata della versione GRATUITA, BASIC e COMPLETA.
---- En la modalidad GRATUITA, durante los primeros 90 dias usted podra probar y trabajar con la version BASICA, pasado ese periodo podra volver a la version gratuita o pasar a la version BASICA o COMPLETA. Recuerde que esta version GRATUITA  es para empr|---- Nella modalità FREE, durante i primi 90 giorni puoi provare a lavorare con la versione BASIC, dopo questo periodo puoi tornare alla versione gratuita o andare alla versione BASIC o COMPLETA. Ricorda che questa versione GRATUITA è per il business
- La empresa Tpv 123 - Gratuito no es responsable si el cliente formatea el equipo o es atacado por algun tipo de virus que provoque la perdida de informacion o de licencia.|- La società Tpv 123 - Gratuito non è responsabile se il cliente formatta l'attrezzatura o viene attaccata da qualche tipo di virus che causa la perdita di informazioni o la licenza.
- Tpv 123 - Gratuito recomienda la compra, para el buen funcionamiento del programa, de una impresora de tickets EPSON/SAMSUNG/Star o cualquier modelo de impresora, siempre que se instale junto con los drivers de dicha impresora. (Tipo de conexion recomen|- TPV 123 - Free raccomanda l'acquisto, per il corretto funzionamento del programma, una stampante di scontrini EPSON / SAMSUNG / Star o modello di stampante, a condizione che sia installato con i driver per quella stampante. (Tipo di connessione recomen
- Este es un programa estandar, no se hacen modificaciones a medida o personalizaciones, nuestros clientes en version BASICA y COMPLETA si pueden sugerirnos algunos cambios que nosotros sin ningun coste añadido incluiremos en siguientes versiones.|- Si tratta di un programma standard, senza modifiche o personalizzazioni come lo sono i nostri clienti in versione base e completa se si può suggerire alcune modifiche che non abbiamo aggiunto costo includere nelle versioni successive.
- Si usted esta utilizando la version GRATUITA y necesita algun tipo de asistencia recuerde que tiene que contratar la version BASICA o COMPLETA dependiendo de su incidencia.|- Se stai utilizzando la versione GRATUITA e hai bisogno di assistenza, ricorda che devi contrarre la versione BASIC o COMPLETA in base alla tua incidenza.
Al instalar este programa,usted acepta las siguientes condiciones:|Installando questo programma, accetti le seguenti condizioni:
CONDICIONES DE USO DEL PROGRAMA|CONDIZIONI DI UTILIZZO DEL PROGRAMMA
Promociones Fast Food|Promozioni fast food
Zonas|aree
SubFamilias|sottofamiglie
Productos Elaborados|Prodotti trasformati
Productos|produrre
Familias|famiglie
Varios Precios|Vari prezzi
Formas de Pago|Forme di pagamento
Empleados|personale
Clientes|clienti
Proveedores|fornitori
Aceptar|accettare
Cancelar|annullare
Eliminar|rimuovere
Modificar|cambiamento
Nuevo|nuovo
No Movimiento|Nessun movimento
Productos relacionados con el proveedor:|Prodotti relativi al fornitore:
Dia de Visita:|Visita il giorno:
Número de Cuenta:|Numero di conto:
Nombre del Banco|Nome della banca
Dia de Pago:|Giorno di pagamento:
Forma de Pago:|Metodo di pagamento:
Observaciones:|osservazioni:
Correo Electrónico:|E-mail:
Móvil / Celular:|Cellulare / cellulare:
Teléfono:|telefono:
Dirección:|indirizzo:
Población:|popolazione:
Código Postal:|Codice postale:
Provincia:|Provincia:
País:|paese:
DNI / CIF|DNI / CIF
Contacto:|contattare:
Nombre|nome
Gestion de Proveedores|Gestione dei fornitori
Lista de Proveedores|Elenco dei fornitori
Ver Ingredientes|Vedi ingredienti
Ver Productos Venta|Vedi la vendita dei prodotti
Zona:|zona:
    Buscar Por Nombre:|    Cerca per nome:
Codigoproducto|Prodotto Codigo
Barra|bar
Cocina|cucina
Ambos|entrambi
situaciongrid|situaciongrid
Posicion  en Pantalla:|Posizione dello schermo:
Ingredientes|ingredienti
Producto para Venta|Prodotto in vendita
Mostrar en Pantalla de Caja:|Mostra nella finestra di dialogo:
Precio de Venta:|Prezzo di vendita:
Impuesto:|Tasse:
grid_ingredientes|grid_ingredientes
grid_productosventas|grid_productosventas
Descripcion Numerica:|Descrizione Numerica:
Seleccionar Color:|Seleziona colore:
Insertar Imagen|Inserisci immagine
Tipo de Producto:|Tipo di prodotto:
Producto preparado en:|Prodotto preparato in:
Coste:|costo:
Stock Actual:|Stock corrente:
Stock Minimo:|Scorte minime:
Proveedor:|il fornitore:
Codigo de Barras:|Codice a barre:
Unidades de medida:|Unità di misura:
Nombre del Producto:|Nome del prodotto:
Gestion de Productos|Gestione del prodotto
Buscar|ricerca
Resultados de la Busqueda|Risultati della ricerca
panel de busqueda de clientes|pannello di ricerca del cliente
Buscar Clientes|Cerca clienti
** DOBLE CLIC EN EL CLIENTE DESEADO|** DOPPIA CLIC SUL CLIENTE DESIDERATO
Rellene algun campo para la busqueda|Compila alcuni campi per la ricerca
DNI/ CIF|DNI / CIF
Tlf Movil|Telefono cellulare
Telefono|telefono
Email|e-mail
Provincia|provincia
Poblacion|Poblacion
Apellidos|cognomi
CP|CP
Codigo Cliente|Codice cliente
situacion|situazione
Descuento %|sconto%
historico ventas|vendite storiche
datos|dati
Lista Ultimos 50 Clientes|Ultimi 50 clienti
Puerta|porta
Numero|numero
Piso|appartamento
Direcccion|STERZO
Nombre *|Nome *
situacion buscar|ricerca di situazioni
Gestion de Clientes|Gestione del cliente
Familia Tipo Menu Combo|Tipo di famiglia Menu Combo
Familia Tipo Menu|Menu tipo di famiglia
Familia Generica|Famiglia generica
Gestion de Familias|Gestione familiare
Clic sobre la familia para ver mas detalles|Clicca sulla famiglia per vedere maggiori dettagli
Lista de Familias|Elenco delle famiglie
*Pulse en la familia para ver los productos agregados a la misma|* Clicca sulla famiglia per vedere i prodotti aggiunti ad essa
Seleccione el tipo de familia|Seleziona il tipo di famiglia
Lb_stopanelproductos|Lb_stopanelproductos
Esta familia no tiene productos relacionados|Questa famiglia non ha prodotti correlati
lista productos|elenca i prodotti
Clic en el producto que desee incluir en su familia|Clicca sul prodotto che vuoi includere nella tua famiglia
Lista de Productos |Elenco dei prodotti
Añadir Productos|Aggiungi prodotti
Tipo de Familia:|Tipo di famiglia:
Label5|Label5
datos generica|dati generici
datos familia generica|dati di famiglia generici
Imagen|immagine
Datos de la Familia|Dati familiari
Mostrar en Caja |Mostra nella casella
Posicion en Pantalla|Posizione dello schermo
Descripcion Numerica|Descrizione Numerica
Productos Incluidos|Prodotti inclusi
panel menu familia|famiglia di menu del pannello
Producto incluido en otra familia|Prodotto incluso in un'altra famiglia
Productos Tercer Plato/ Postre|Terzo piatto / prodotti da dessert
Productos Segundo Plato|Prodotti seconda piastra
Productos Primer Plato|Prodotti per la prima lastra
Añadir Postre|Aggiungi dessert
Añadir Segundo|Aggiungi secondo
Añadir Primero|Aggiungi prima
Impuesto|imposta
Precio de Venta|Prezzo di vendita
tipo|tipo
NO BORRAR|NON CANCELLARE
situacion paneles|pannelli di situazione
Añadir + Productos a la SubFamilia|Aggiungi + prodotti alla sottofamiglia
Clic en el producto que desee incluir en el subproducto|Fare clic sul prodotto che si desidera includere nel sottoprodotto
Familia a la que pertenece|Famiglia a cui appartiene
datos subfamilia|dati di sottofamiglia
Datos de la SubFamilia|Dati della sottofamiglia
SubFamilias Existentes|Sottofamiglie esistenti
Num S.S.:|Num S.S .:
Repartidor:|liberatore:
Apellidos:|Cognome:
Color en Caja:|Colore nella scatola:
Número de  Cuenta:|Numero di conto:
Nombre  del Banco:|Nome della banca:
Foto:|foto:
Correo  Electrónico:|E-mail:
NIF/ CIF:|NIF / CIF:
Nombre:|nome:
Lista de Empleados|Elenco dei dipendenti
Gestion de Empleados|Gestione dei dipendenti
*clic para ver datos del producto|* clicca per vedere i dati del prodotto
top grid|griglia superiore
Sirve para que en lugar de que  aparezca una imagen en el boton  del producto aparezca un numero.|Serve in modo che, invece di apparire un'immagine sul pulsante del prodotto, venga visualizzato un numero.
alturacandidadingredientes|alturacandidadingredientes
Es el lugar donde queremos que se  muestre el producto en caja cuando hacemos clic sobre su familia.|È il luogo in cui vogliamo mostrare il prodotto nella confezione quando clicchiamo sulla tua famiglia.
nombreproducto|ProductName
Codigo|codice
CantidaddeIngredientes|Quantità di ingredienti
Cantidad|quantità
Ingredientes Incluidos en el Producto: |Ingredienti inclusi nel prodotto:
Ver Datos Completos|Vedi dati completi
¿cuantos|Quanti?
sto ingredientes|sto ingredienti
Producto Elaborado|Prodotto trasformato
Producto preparado en|Prodotto preparato in
Descripcion  Numerica:|Descrizione Numerica:
situacion izquierda|situazione a sinistra
situacion derecha|giusta situazione
alturagrid|alturagrid
Seleccione el producto o el ingrediente a utilizar|Seleziona il prodotto o l'ingrediente da utilizzare
Ver Productos|Vedi i prodotti
Gestion de Productos Elaborados|Gestione dei prodotti trasformati
Ver Ingredientes Incluidos|Vedi ingredienti inclusi
Añadir Producto|Aggiungi prodotto
Nuevo Precio|Nuovo prezzo
Precio Actual|Prezzo corrente
Añadir Nuevos Productos|Aggiungi nuovi prodotti
Producto|prodotto
Precio Original|Prezzo originale
Precios Validos entre los siguientes dias y horas|Prezzi validi tra i seguenti giorni e ore
Hora Hasta|Ora fino a
Hora Desde|Tempo da
Fecha Hasta|Data fino a
Fecha Desde|Data da
Nombre de la lista|Nome della lista
SITUACION DE LOS PANELES|SITUAZIONE DEI PANNELLI
Id lista|Lista di identificazione
Fecha de Alta|Data di registrazione
Desde|da
Hasta|su
Horario Desde|Pianifica da
Horario Hasta|Pianificare
Ver Lista|Vedi elenco
Lista de Precios Existentes|Listino prezzi esistente
Volver Lista de Precios|Indietro Listino prezzi
Lista de Precios|Listino prezzi
Productos de Barra|Prodotti di Barra
Productos de cocina|Prodotti da cucina
Esta zona la voy a utilizar para|Userò quest'area a
Zonas Existentes|Aree esistenti
Zonas de Impresion|Aree di impressione
Diseño|disegno
Otro Terminal|Altro terminale
Reservada|riservato
Ocupada|occupato
Libre|gratis
Panel Mesas|Tabelle del pannello
Mesas|tavoli
Diseño Salon|Salon Design
Reservas|prenotazioni
Salones|saloni
Reserva|riserva
Total|totale
Tablet Activada|Tablet attivato
Visor Pedidos|Visualizzatore degli ordini
Bit|po '
Pedido Telefonico|Ordine telefonico
Envio|consegna
Juntar Cuentas|Unisciti agli account
SALON|SALON
EMPLEADO|DIPENDENTE
codigoempleado|codice dipendente
PEDIDO|ORDINE
H. INICIO|H. HOME
MESA|TABELLA
Cant.|Cant.
Precio|prezzo
Primero|prima
Segundo|secondo
Postre|dessert
Desc|DESC
Num_Factura|Num_Factura
Recargo|sovrapprezzo
Producto de Menu|Prodotto di Menu
Menu|menu
Codigo del Menu|Codice menu
Servido|servito
Tipo de Impuesto|Tipo fiscale
Cod Empleado|Dipendente del merluzzo
codigo Familia|Codice famiglia
Indice|contenuto
Cod. Prod.|Cod. Prod.
Orden Menu|Menu Ordine
ZonaImpresion|Area delle impressioni
BEBIDAS/ POSTRES|BEVANDE / DOLCI
PRIMER PLATO|PRIMA PIASTRA
SEGUNDO PLATO|SECONDO PIATTO
situacion panel producto|situazione del pannello di prodotto
Opciones|opzioni
Cobrar|carica
Abrir  Cajetin|Apri Cajetin
Preticket|Preticket
Enviar a cocina|Invia alla cucina
Borrar Venta|Elimina vendita
Observ. Pedido|Ho osservato ordine
Crear/Modificar Salones|Crea / Modifica stanze
Diseño de Salones|Progettazione di camere
Elementos para  el diseño|Elementi per il design
Posicion del objeto/mesa|Posizione dell'oggetto / tabella
Eliminar Mesa|Rimuovi tabella
Eliminar Objeto|Elimina oggetto
Guardar Numero|Salva numero
Numero Mesa|Tabella dei numeri
Eliminar Diseño Salon|Rimuovi salone di design
Boton Pulsado|Pulsante pulsato
Objeto Pulsado|Oggetto pulsato
Esta diseñando el:|Sta progettando il:
Alta Salones/ Barra|Sale alte / Bar
Lista de Salones - Barras|Elenco delle camere - Bar
Recargo:|supplemento:
Posicion En Pantalla:|Posizione dello schermo:
Color Salon|Color Salon
Imagen Mesas|Tabelle di immagini
Nro de Mesas:|Numero di tabelle:
Imagen Salon|Immagine del salone
Cambiar Idioma / Change Language|Cambia lingua / Cambia lingua
Base De Datos|Database
Contraseña Director|Director password
Importar Imagenes del Servidor|Importa immagini dal server
Permisos Usuario|Autorizzazioni utente
Importar Datos|Importa dati
Cierre Año|Anno vicino
Envio Informes|Rapporti di spedizione
Conexion en Red|Connessione di rete
Aumento Precio|Aumenta il prezzo
Horario|orario
Diseño Ticket / Factura|Disegno del biglietto / fattura
Cajetin|scatola
Impresoras|stampanti
Copia de Seguridad|Copia di backup
Configuracion Regional|Impostazioni regionali
Datos de la empresa|Dati dell'azienda
situacionpaneles|situacionpaneles
Esta a punto de restaurar una copia de seguridad, recuerde que este proceso es irreversible y cambiara la base de datos con la que trabaja en estos momentos por la seleccionada |Stai per ripristinare un backup, ricorda che questo processo è irreversibile e cambierà il database con cui stai attualmente lavorando per quello selezionato
Hacer Copia de Seguridad|Crea backup
Restaurar Copia de Seguridad|Ripristina il backup
Administracion Permisos|Amministrazione delle autorizzazioni
Nro. de copias del preticket|Numero di copie pre-ticket
Nro. de copias del ticket|Numero di copie del biglietto
Centrado|centrato
OFF|OFF
ON|ON
Enviar Confirmacion Reserva|Invia conferma prenotazione
Enviar email al director / cierre caja|Invia e-mail al regista / casella di chiusura
Realizar cierre caja ciego|Eseguire la chiusura della scatola cieca
Pedir Contraseña Al Entrar Al Programa|Richiedi password quando si accede al programma
Permisos Usuarios|Autorizzazioni degli utenti
Pedir contraseña para las modificaciones / eliminaciones / descuentos ... (Para todos los empleados)|Chiedi password per modifiche / cancellazioni / sconti ... (per tutti i dipendenti)
Pedir Contraseña Apertura de Cajetin|Richiesta password Cajetin Opening
Pedir Contraseña Al Entrar Caja|Chiedi password quando si entra nella casella
Pedir Empleado Al Entrar Caja|Chiedi al dipendente quando si entra nella casella
Activar Opciones|Attiva opzioni
Pedir Contraseña|Chiedi password
Pedir Empleado X Cada Venta|Chiedi per Dipendente X Ogni vendita
Utilizar Caja Rapida|Usa Quick Box
Entrar en modo Direccion|Entra in modalità Indirizzo
¿Ha olvidado su contraseña?|Hai dimenticato la tua password?
No ha seleccionado ningun empleado|Non hai selezionato nessun dipendente
Ingrese su clave:|Inserisci la tua password:
SELECCIONE EL EMPLEADO|SELEZIONA IL DIPENDENTE
Nombre de la Empresa|Nome dell'azienda
Ingrese el nro. de percha|Inserisci il numero di appendiabiti
lb-_Empleado|lb-_Empleado
Cambio Precio|Cambia prezzo
Cierre De Caja|Scatola chiusa
Imprimir Resguardo|Stampa Resguardo
Imprimir Ticket|Stampa il biglietto
Abrir Cajetin|Apri Cajetin
Terminar Venta|Vendita finita
Importe Total Prendas|Quantità totale di indumenti
Entrega cliente|Consegna del cliente
Devolucion|RITORNO
Venta Anterior|Vendita precedente
Nro Prendas|No. Indumenti
Caja - Ropero|Box - Guardaroba
Entrada Seleccionada|Voce selezionata
Entrada + consumicion|Ingresso + consumo
Entrada Seleccionada:|Voce selezionata:
Seleccion De Entradas|Selezione dei biglietti
Nombre del Visor:|Nome visualizzatore:
Utilizar Visor|Usa Viewer
Eliminar Impresoras de este teminal|Rimuovi stampanti da questo terminale
La impresora se ha dado de alta correctamente|La stampante è stata registrata con successo
Seleccione la celda en la interseccion de la impresora y la zona que quiere asociar|Selezionare la cella all'intersezione della stampante e l'area che si desidera associare
Configuracion de Impresoras|Configurazione della stampante
Gestion de Impresoras|Gestione della stampante
Reenvio de Pedidos A cocina / Barra|Inoltro di ordini a cucina / bar
* click en la linea que desea reimprimir|* fai clic sulla linea che desideri ristampare
Zona Impresion|Zona di impressione
Hora|tempo
numPedido|I ordno
Fecha|data
enviado|inviato
Detalles del Pedido|Dettagli dell'Ordine
Reenviar|in avanti
NumPedido =|OrderNum =
Guardar|salvare
Descuento a aplicar|Sconto da applicare
lblCliente|lblCliente
Terminar Venta <F12>|Fine vendita <F12>
Descuento|sconto
Buscar Cliente|Cerca cliente
Cambio|cambiamento
Cliente entrega Efectivo|Cliente di consegna in contanti
Cliente paga con Tarjeta|Il cliente paga con la carta
Formato de Impresion|Formato di stampa
Formato A4|Formato A4
Formato A5|Formato A5
Tamaño 10 cm.|Dimensioni 10 cm.
Imprimir factura|Stampa la fattura
SubTotal|SubTotal
Propina|punta
Enviar ticket Correo Electronico|Invia il biglietto E-mail
Cerrar Venta|Chiudi la vendita
Imprimir en Cocina|Stampa in cucina
V E R  T I C K E T|V E R T I C K E T
Tipo de venta|Tipo di vendita
Factura|fattura
Boleta Formato Ticket|Biglietto formato biglietto
Ultima Venta|Ultima vendita
Diseño de salon|Salone di design
Eliminar Venta Ya Cobrada|Elimina la vendita già raccolta
Cobro Parcial|Collezione parziale
Reservas de Mesas|Prenotazioni al tavolo
Listados Caja|Casella di annunci
Retirada de Caja|Prelievo di contanti
Gastos del Dia|Spese giornaliere
Activar Precios para este Terminal|Attiva i prezzi per questo terminale
Reimpresion Ticket|Biglietto di ristampa
Modificacion de Tickets|Modifica dei biglietti
Conteo y cierre de caja|Conteggio e chiusura di contanti
situacion panel opciones|opzioni di situazione del pannello
panel_opciones de caja|contanti panel_opciones
CONFIGURACION OPCIONES CAJA|OPZIONI DI SCATOLA DI CONFIGURAZIONE
Regresar al idioma original|Ritorno alla lingua originale
¿Confirma que desea eliminar el siguiente registro?|Sei sicuro di voler cancellare il prossimo disco?
Idiomas|lingue
Usted ha seleccionado|Hai selezionato
Ninguno|nessuno
¿Seleccione el Idioma?|Seleziona la lingua?
Texto Traducido|Testo tradotto
Texto Original|Testo originale
id|id
Texto|testo
Traduccion|traduzione
lineas sin traducir|linee non tradotte
Click sobre la linea para añadir una traduccion|Clicca sulla linea per aggiungere una traduzione
Click sobre la linea para modificar la traduccion|Clicca sulla linea per modificare la traduzione
Texto sin traducir|Testo non tradotto
Condiciones|condizioni
Registro de Licencias|Registrazione delle licenze
Acerca de ...|Informazioni su ...
TPV Gratuito|POS gratuito
B. Aires - Argentina|B. Aires - Argentina
D. F. - Mexico|D. F. - Messico
Santiago de Chile|Santiago, Cile
Lima - Peru|Lima - Perù
Costa Rica|Costa Rica
Puerto Rico|Porto Rico
Miami - Florida|Miami - Florida
Bogota - Colombia|Bogotà - Colombia
Mantenimiento registrado hasta:|Manutenzione registrata fino a:
Fecha de Caducidad:|Data di scadenza:
Fecha de Instalacion:|Data di installazione:
TPV Gratuito, Departamento de Desarrollo|POS gratuito, dipartimento di sviluppo
Ultima actualizacion: XXX|Ultimo aggiornamento: XXX
Fecha de creacion:  XXX|Data di creazione: XXX
Proyecto: Tpv 123, Version: XXX|Progetto: Tpv 123, Versione: XXX
Paseo de Europa 7, (S.S. de los Reyes - Madrid -España)|Walk of Europe 7, (S.S. de los Reyes - Madrid-Spagna)
Buenos Aires - Argentina|Buenos Aires - Argentina
E-mail: compras@tpvgratuito.com   www.tpvgratuito.com|E-mail: compras@tpvgratuito.com www.tpvgratuito.com
Servicio de asistencia:|helpdesk:
Reg. Anual|Reg. Annuale
Usted está utilizando una licencia:|Stai utilizzando una licenza:
SolverMedia|SolverMedia
SolverMedia, Departamento de Desarrollo|SolverMedia, Development Department
Fecha de creacion: XXX|Data di creazione: XXX
Proyecto: Servidor Net, Version: XXX|Progetto: Net Server, Versione: XXX
No hay datos para ser mostrados|Non ci sono dati da mostrare
Listado de Empleados|Elenco dei dipendenti
Listado de Familias|Elenco delle famiglie
Listados Generales|Annunci generali
Ventas NCF Rep. Dominicana|Vendite NCF Rep. Dominicana
Ventas con Promociones|Vendite con promozioni
Productos Bajo Minimo|Prodotti minimi minimi
Reimprimir Factura - Ticket|Ristampa la fattura - Biglietto
Ventas x Clientes|Vendite x Clienti
Imprimir Letreros  y  Etiquetas |Stampa segni ed etichette
Estadisticas|statistica
Valoracion Stock x Proveedores|Scorte di valutazione x Fornitori
Valoracion Stock General|Valutazione generale delle scorte
Listado de Proveedores|Elenco dei fornitori
Listado de Clientes|Elenco dei clienti
Listado de Productos|Elenco dei prodotti
Servicios a Domicilio|Servizi domestici
Consumo de Platos Menu|Menu di consumo del piatto
Reservas x Dia|Prenotazioni x giorno
Pedidos Realizados a Proveedor|Ordini fatti al fornitore
Empleado del Mes|Impiegato del mese
Estadistica x Repartidor|Statistiche x rivenditore
Retiradas Empleados|Dipendenti ritirati
Relacion Envios Cocina contra Ventas|Rapporto di spedizione Cucina vs. Vendite
Formato Din-A4|Formato Din-A4
Formato Ticket|Formato del biglietto
Total Diario de Retiradas|Prelievi giornalieri totali
Ventas x Zonas|Vendite x aree
Caja Total x Dias|Totale casella x giorni
Gastos de Caja|Spese in contanti
Descuentos Realizados|Sconti fatti
Ventas en el mes (Acumulado x Horas)|Vendite nel mese (Ore x accumulate)
Reservas Hora/Dia /Mes|Prenotazioni ora / giorno / mese
Ventas x Empleados|Vendite x dipendenti
Impuestos Repercutidos|Tasse tassate
Gastos|spese
Relacion de Propinas|Rapporto di punta
Ventas x Menus|Vendite x Menu
Resumen Contable de Facturas|Riepilogo contabilità fatture
Productos mas Vendidos|La maggior parte dei prodotti venduti
Productos Sin Ventas|Prodotti senza vendite
Ventas x Horas|X ore di vendita
Resumen de Venta x Empleados|Riepilogo della vendita x Dipendenti
Ventas Detalladas x Empleados|Vendite dettagliate x Dipendenti
Ventas Eliminadas y Descuentos|Vendite e sconti eliminati
Ventas x Zonas -Totalizado x Productos|Vendite x aree -Totalizzati x prodotti
Ventas Generales x Dia|Vendite generali x giorni
Ventas x Familias|Vendite x Famiglie
Ventas x Zonas Formato General|Formato generale vendite x aree
Ventas x Forma de Pago|Vendite x Forma di pagamento
Ventas Formato Ticket Resumido|Formato ticket riepilogo vendite
Ventas Formato Ticket x Empleado|Sales Format Ticket x Employee
Productos Bajo Minimos Formato Ticket|Prodotti in formato ridotto
Ventas Eliminadas Formato Ticket|Biglietto di vendita formato cancellato
Cierres de Caja Formato Ticket|Biglietto formato chiusure cassa
Ventas Formato Ticket Detallado|Formato del biglietto dettagliato delle vendite
Subproductos|sottoprodotti
Eliminar Datos de Prueba|Elimina dati di test
Configuracion Empresa|Configurazione della compagnia
Datos de la Factura|Dati della fattura
Ultimo Nro. Utilizado = |Ultimo usato No =
Factura Numero|Numero di Bill
Numeracion de factura|Numero della fattura
No Incluidos|Non incluso
Incluidos|incluso
Impuestos|tassazione
Ancho A5 (14cm)|Larghezza A5 (14 cm)
Ancho 10 cm|Larghezza 10 cm
Ancho A4 (21cm)|Larghezza A4 (21 cm)
Formato de Factura|Formato della fattura
Logo de la Empresa|Logo dell'azienda
Pagina Web|sito web
Direccion|indirizzo
Pais|paese
Codigo Postal|Codice postale
Detalles de la Empresa|Dettagli aziendali
Recuerde que en la carpeta indicada en la linea superior tiene que existir el archivo nomprog.|Ricorda che nella cartella indicata nella riga superiore deve esistere il file nomprog.
Paso1: Confirme que todos sus equipos esten conectados en red.  Paso2: De todos los equipos que tiene, tiene que seleccionar uno que va a hacer de servidor.  Paso3: El equipo que hara de servidor tiene que tener el disco C compartido y con los permiso|Passaggio 1: verificare che tutti i computer siano connessi in una rete. Step2: Di tutto l'equipaggiamento che hai, devi selezionarne uno che diventerà un server. Passaggio 3: il team che eseguirà il server deve disporre del disco condiviso C e dell'autorizzazione
Nota: Localice el equipo que hara de servidor que la base de datos la encontrara en |Nota: individuare il computer che farà in modo che il server lo trovi nel database
Conectar con la base de datos|Connettiti con il database
Como tiene que poner su equipo  en modo red local (varios equipos)|Come mettere il computer in modalità di rete locale (diversi computer)
Conexion con otro Terminal|Connessione con un altro terminale
Permisos de Usuario|Autorizzazioni utente
Seleccione el empleado al que va a configurar permisos|Seleziona il dipendente a cui hai intenzione di impostare le autorizzazioni
Cambio Guardado|Cambiamenti salvati
Cambio de Clave|Cambio di password
* Maximo 8 caracteres|* Massimo 8 caratteri
Confirmacion|conferma
Nueva|nuovo
Antigua|Antigua
Cambiar Contraseña|Cambia password
Cambios guardados|Modifiche salvate
Aplicar Cambios para este Empleado|Applica modifiche per questo dipendente
Borrar Restricciones|Elimina restrizioni
Opciones configurables|Opzioni configurabili
NO Permite acceso al modulo|NO Consente l'accesso al modulo
Permite acceso al modulo|Consente l'accesso al modulo
Seleccione su pais|Seleziona il tuo paese
Nombre del Impuesto (IVA, IGIC, IGV, etc.)|Nome della tassa (IVA, IGIC, IGV, ecc.)
Si en su pais no se aplica esta normativa, NO ACTIVE esta opcion|Se questo regolamento non si applica nel tuo paese, NON attivare questa opzione
Si ACTIVA esta opcion, en las facturas el num. le aparecera asi: 000- 000-00-0000000X|Se si attiva questa opzione, nelle fatture il num. apparirà in questo modo: 000-000-00-0000000X
En algunos paises la normativa indica que el numero de facturas tiene que ir precedido por una serie de identificadores.|In alcuni paesi, i regolamenti indicano che il numero di fatture deve essere preceduto da una serie di identificatori.
INFORMACION SOBRE FACTURAS ESPECIALES|INFORMAZIONI SULLE FATTURE SPECIALI
Moneda|valuta
Simbolo Moneda|Simbolo di valuta
Formato Hora:|Formato orario:
Numero de decimales ( 0,1,2)|Numero di decimali (0,1,2)
Identificacion Fiscal (Cif, Nif, Ruc, Rut, Rnc, etc.)|Identificazione fiscale (Cif, Nif, Ruc, Rut, Rnc, ecc.)
h=12 Horas (AM o PM)|h = 12 ore (AM o PM)
h=24 Horas |h = 24 ore
Otra Moneda|Altra valuta
Btc 1 BitCoin = |Btc 1 BitCoin =
€ 1 Euro = |€ 1 Euro =
$ 1 Dolar = |$ 1 dollaro =
Hasta 8 decimales|Fino a 8 decimali
Numero de credito fiscal|Numero di credito fiscale
Activar linea propina en preticket|Attiva la linea di punta nel preticket
Guardar Cambios|Salva modifiche
Ingrese el concepto|Inserisci il concetto
Activar concepto Propina / Servicio / Otros|Attiva il concetto Mance / Servizio / Altro
(Opcion utilizada con frecuencia en algunos paises del caribe y sudameria) / No activar en paises en los que no es obligatorio cobrar propina|(Opzione utilizzata frequentemente in alcuni paesi dei Caraibi e Sudameria) / Non attivare in paesi in cui non è obbligatorio addebitare suggerimenti
Secuencia de Apertura|Sequenza di apertura
Para impresoras conexion paralela:|Per stampanti con connessione parallela:
Probar / Guardar|Test / Salva
* Click para seleccionar la secuencia de apertura|* Fare clic per selezionare la sequenza di apertura
Marca de Impresora|Marca della stampante
Modelo de Impresora|Modello di stampante
Otras secuencias de apertura|Altre sequenze di apertura
Nota: Es posible que la impresora realice el corte sin tener que añadir ninguna secuencia de apertura, en ese caso no hace falta que configure esta opcion|Nota: è possibile che la stampante esegua il taglio senza dover aggiungere alcuna sequenza di apertura, in tal caso non è necessario configurare questa opzione
* Click para seleccionar la secuencia de corte|* Fare clic per selezionare la sequenza di taglio
Secuencia de Corte|Sequenza di taglio
Otras secuencias de Corte de Papel|Altre sequenze di taglio della carta
Configuracion de corte automatico al final del ticket:|Configurazione di taglio automatica alla fine del biglietto:
¿Que son comandos adicionales? Despues de instalar los drivers de la impresora en propiedades de la misma encontramos una pestaña de comandos adicionales / desde aqui marcaremos la opcion de apertura de cajon (Open Draw1 o Open Draw2).|Quali sono i comandi aggiuntivi? Dopo aver installato i driver di stampa in proprietà dello stesso trovare una scheda di comandi aggiuntivi / da qui contrassegniamo l'opzione per aprire il cassetto (Apri Draw1 o Apri Draw2).
Apertura estandar para impresoras USB|Apertura standard per stampanti USB
Para impresoras con comandos adicionales: (serie, paralelo, usb)|Per stampanti con comandi aggiuntivi: (serie, parallelo, usb)
Para impresoras salida serie:|Per stampanti con uscita seriale:
Configuracion de Apertura de Cajon|Cajon Opening Configuration
Si conoce que tipo de conexion tiene su impresora de tickets seleccione la que le corresponde en caso contrario pruebe cada uno de ellos hasta confirmar cual es el que abre.|Se sai quale tipo di connessione ha la stampante per biglietti, seleziona quella che corrisponde ad essa, altrimenti prova ognuno di essi fino a quando confermi quale si apre.
Ayuda|aiutare
Configuracion de Cajetin|Configurazione di Cajetin
Courier New|Corriere Nuovo
Seleccione Tamaño Letra: Cuerpo|Seleziona Formato Lettera: Corpo
Seleccione Tamaño Letra: Titulo|Seleziona la dimensione della lettera: titolo
Seleccione Tipo Letra|Seleziona Tipo Lettera
Tipo / Tamaño Letra|Digita / taglia la lettera
Nro. de Decimales que quiero utilizar|No. di decimali che voglio usare
Mi impresora imprime|La mia stampante stampa
Nro. de caracteres de su impresora|Numero di caratteri della stampante
caracteres por linea|caratteri per riga
Poblacion:|popolazione:
Direccion:|indirizzo:
Tel:|Tel:
CIF / DNI:|CIF / DNI:
Cliente:|cliente:
Empleado:|Impiegato:
Fact. Simpli:|Fatto. semplificazione:
Codigo Barras|Codice a barre
Lineas en blanco al final del ticket = |Righe vuote alla fine del biglietto =
Escriba aqui su comentario del final de ticket|Scrivi qui il tuo commento del biglietto
** Gracias por su visita **|** Grazie per la tua visita **
Impuestos Incluidos|Tasse incluse
Varias lineas para descripcion del producto|Diverse linee per la descrizione del prodotto
Añadir codigo de barras en descripcion de producto|Aggiungi codice a barre nella descrizione del prodotto
Otras Opciones|Altre opzioni
Mostrar P. Unitario|Mostra P. Unitario
Desglose Impuesto|Scomposizione fiscale
Total en Letras|Totale in lettere
Utilizar SubTotal|Usa subtotale
Cuota|tassa
Base|base
Tipo IVA|Tipo di IVA
Entrega|consegna
P. U.|P. U.
Descripcion|descrizione
Uds|voi
WEB|WEB
Puede cambiar|Puoi cambiare
CIF|CIF
Nombre Empresa|Nome dell'azienda
Imagen al Principio|Immagine all'inizio
Datos de Cabecera|Dati di intestazione
Clic para cambiar Imagen|Clicca per cambiare immagine
Nro Venta/Pie de Ticket|Nessuna vendita / piede del biglietto
Diseño Ticket|Design del biglietto
Valor de venta en letras|Valore di vendita in lettere
Diseño de Ticket|Progettazione del biglietto
Pie de Ticket|Biglietto
Detalles del  Ticket|Dettagli del biglietto
Vista Previa|anteprima
Cabecera  Ticket|Intestazione del biglietto
Datos del  Cliente|Dati del cliente
Clave:|chiave:
Usuario: Director|Utente: direttore
Está a punto de realizar la restauración de sus copias de seguridad de sus bases de datos.  Para ello deberá localizar su copia de seguridad en su disco duro o en su modulo de memoria extraible.  Dicha operación demorará unos segundos, una vez finaliz|Stai per ripristinare le tue copie di backup dei tuoi database. Per fare ciò è necessario individuare la copia di backup sul disco rigido o sul modulo di memoria rimovibile. Tale operazione richiederà alcuni secondi, una volta terminata
TPV Hosteleria|Terminale POS Hosteleria
Grafica de Envios|Grafica di spedizione
Relacion Emails Enviados|Email di relazioni inviate
Envio Promocion|Promozione della spedizione
Crear Plantillas Reservas|Crea prenotazioni di modelli
Envio Puntual|Spedizione puntuale
Crear Plantillas|Crea modelli
Activar Servicio De Correos|Attiva il servizio postale
Enviados:|inviato:
Label6|Label6
Saldo:|bilancio:
Su ID Es|Il tuo ID è
Servicio Correo|Servizio di posta
Le hemos asignado  20 correos gratis|Ti abbiamo assegnato 20 email gratuite
Su registro se ha realizado con exito|La tua registrazione è stata completata con successo
Nombre de Usuario|nome utente
Correo de Contacto|Email di contatto
Incluir Logo|Includi logo
Pie de Correo|Posta di piede
Configuracion Correo|Configurazione della posta
Mensaje Enviado|Messaggio inviato
Enviar|inviare
Envio Puntual de Correo|Invio di posta
toolStrip1|toolStrip1
Mensaje|messaggio
Remitente|mittente
Asunto|affari
Destinatario|destinatario
Seleccione el intervalo de fechas|Seleziona l'intervallo di date
Chart1|chart1
Grafico|grafico
Nueva Plantilla|Nuovo modello
Plantillas Promociones|Modelli di promozioni
Guardado Correctamente|Salvato correttamente
No|non
Sí|sì
¿Desea cargar el diseño anterior?|Vuoi caricare il progetto precedente?
Nombre Plantilla|Nome del modello
Plantilla 3|Modello 3
Plantilla 2|Modello 2
Plantilla 1|Modello 1
Plantilla|sagoma
<---- Texto que aparece en el cuerpo de la promocion|<---- Testo che appare nel corpo della promozione
<---- Escriba el  texto que desea que aparezca en la parte inferior de la promocion|<---- Scrivi il testo che vuoi apparire in fondo alla promozione
<---- Escriba el titulo o el texto que desea que aparezca en la cabecera de la promocion|<---- Scrivi il titolo o il testo che vuoi apparire nell'intestazione della promozione
Pie de página|footer
Titulo|titolo
<---- Haga un click para insertar la imagen|<---- Clicca per inserire l'immagine
Plantilla Guardada|Template salvato
Cuerpo del Mensaje|Corpo del messaggio
Plantilla Reservas|Prenotazione dei modelli
<---- Texto que se genera automaticamente|<---- Testo che viene generato automaticamente
<---- Escriba el  texto que desea que aparezca en la parte inferior de la reserva|<---- Scrivi il testo che vuoi apparire in fondo alla prenotazione
<---- Escriba el titulo o el texto que desea que aparezca en la cabecera de la reserva|<---- Digita il titolo o il testo che desideri visualizzare nell'intestazione della prenotazione
Configurar Email|Configura email
Mostrar clientes|Mostra clienti
Filtrar Clientes para Enviar Email|Filtra i clienti per inviare email
Seleccione una opcion|Seleziona un'opzione
Menor que|Meno di
Mayor que|Maggiore di
Consumo|consumo
Ingrese un codigo postal|Inserisci un codice postale
Todos los clientes|Tutti i clienti
Num. Visita|Visita il numero
Cumpleaños|compleanno
Enviando Emails|Invio di email
Cerrar|vicino
Ctrl+C para copiar los correos de esta lista para hacer un envio desde la aplicacion de correo electronico (gmail, hotmail, etc...) que desee.|Ctrl + C per copiare le e-mail da questo elenco per effettuare una spedizione dall'applicazione di posta elettronica (gmail, hotmail, ecc.) Che si desidera.
Lista de correos seleccionados|Elenco delle email selezionate
Enviar Email a Clientes Seleccionados|Invia email ai clienti selezionati
Lista de clientes|Elenco di clienti
 Mostrar Todos| Mostra tutto
Emails Seleccionados|Email selezionate
Marcar Todos|Segna tutti
Copiar Emails seleccionados  para envio manual|Copia le email selezionate per la consegna manuale
 Mostrar solo con Email Valido| Mostra solo con email valida
Clientes Seleccionados|Clienti selezionati
Cantidad de clientes que cumplen las condiciones|Numero di clienti che soddisfano le condizioni
Importe|importo
Visitas|visite
* Si no pone un correo electronico valido no recibirá respuesta|* Se non inserisci un'e-mail valida, non riceverai una risposta
Telefono:|telefono:
Email: *|Email: *
Ingrese sus datos para poder responderle|Inserisci le tue informazioni per essere in grado di rispondere
Formule su Consulta|Fai la tua domanda
Aviso de averia|Avviso di guasto
Pregunta o Consulta|Domanda o consultazione
Tipo de Consulta|Tipo di consultazione
Si tiene alguna Incidencia / Pregunta sobre nuestro programa utilice esta opcion siguiendo los pasos:|Se hai qualche incidenza / domanda sul nostro programma usa questa opzione seguendo i passaggi:
Aviso de Averia / Consulta|Avviso / consultazione
Asistencia y Sugerencias|Assistenza e suggerimenti
Si no tiene contratado este servicio nuestra empresa no tiene la obligacion de dar ningun tipo de servicio o ser responsable de algun cambio de su sistema informatico.|Se non si dispone di questo servizio contratto, la nostra azienda non ha l'obbligo di fornire alcun tipo di servizio o essere responsabile per eventuali cambiamenti nel sistema informatico.
Si la compra de este producto ha superado el año y tiene caducado la asistencia / actualizaciones del programa, y tiene un problema recuerde, primero contratar nuestro servicio de asistencia para una solucion adecuada.|Se l'acquisto di questo prodotto ha superato l'anno e l'assistenza / gli aggiornamenti del programma sono scaduti e si ha un problema a ricordare, prima assumi il servizio di assistenza per una soluzione adeguata.
Cambio de equipo informatico, cambio de disco duro, formateo de disco duro, etc...|Cambio di attrezzature informatiche, modifica del disco rigido, formato del disco rigido, ecc ...
4.- Estimado cliente recuerde que sólo podrá recibir las actualizaciones del programa en caso de tener el contrato de mantenimiento al día.|4.- Gentile cliente, ricorda che puoi ricevere aggiornamenti del programma solo se hai il contratto di manutenzione aggiornato.
3.- Si se produce alguno de estos casos anteriores, antes de realizar ninguna acción,  pongase en contacto con el departamento técnico de SolverMedia comercial@solvermedia.com para que le ayuden a realizar el cambio.|3.- Se si verifica uno di questi casi precedenti, prima di eseguire qualsiasi azione, contattare l'ufficio tecnico di SolverMedia comercial@solvermedia.com per aiutarlo a effettuare la modifica.
2.- La empresa SolverMedia no concederá una nueva licencia a aquellos clientes que por problemas ajenos a SolverMedia hallan perdido el registro del programa, esos problemas pueden venir causados por:|2.- La società SolverMedia non concederà una nuova licenza a quei clienti che, a causa di problemi esterni a SolverMedia, hanno perso il registro del programma, questi problemi possono essere causati da:
1.- La empresa SolverMedia no se responsabiliza de la mala manipulación de su registro de licencia así como del numero asignado para su registro.|1.- La società SolverMedia non è responsabile per la cattiva manipolazione del suo registro di licenza e il numero assegnato per la sua registrazione.
La contraseña de direccion es: |La password dell'indirizzo è:
Maximo 8 caracteres|Massimo 8 caratteri
Confirme la contraseña|Conferma la password
Ingrese la contraseña nueva|Inserisci la nuova password
Ingrese la contraseña anterior|Inserisci la password precedente
Recordatorio de contraseña de direccion|Indirizzo password promemoria
Cambio de contraseña de direccion|Cambio della password di indirizzo
Volver a intentar|Prova di nuovo
Las respuestas introducidas no son correctas|Le risposte inserite non sono corrette
Para poder recordarle la contraseña de direccion es necesario que responda a las siguientes preguntas|Per poter ricordare la password dell'indirizzo, è necessario rispondere alle seguenti domande
Año|anno
Mes|mese
Dia|giorno
Ingrese el segundo apellido de su madre|Inserisci il secondo cognome di tua madre
Indique su fecha de nacimiento|Indica la tua data di nascita
Si olvida la contraseña que acaba de introducir podra recuperarla respondiendo a las preguntas anteriores.|Se si dimentica la password appena inserita, è possibile recuperarla rispondendo alle domande precedenti.
La contraseña y las respuestas de recordatorio se han guardado correctamente.|Le risposte di password e promemoria sono state salvate correttamente.
Boletas|scrutini
Facturas|fatture
codCliente|codCliente
Cliente|cliente
F.Pago|F. Pagamento
** clic en la lista o introduzca el numero de ticket|** clicca sulla lista o inserisci il numero del biglietto
Ingrese el numero de ticket / factura|Inserire il numero del biglietto / fattura
Lista de las ultimas ventas|Elenco delle ultime vendite
Concepto del gasto|Concetto di spesa
Gastos Del Día|Spese giornaliere
Ultimos 50 gastos (clic para modificar)|Ultime 50 spese (clicca per modificare)
ESPACIO|SPAZIO
BORRAR|TRASPARENTE
Deja en Caja :|Lascia in scatola:
Cerrar Ventas/Imprimir|Chiudi vendite / stampa
Observaciones de caja:|Osservazioni di cassa:
Suma/Conteo de caja del turno actual|Somma / Conteggio caso maiuscole corrente
Seleccione las monedas de su pais|Seleziona le valute del tuo paese
Cargar monedas de la Zona Euro|Carica monete dall'Eurozona
Valor n|Valore n
Terminal = XXX|Terminale = XXX
Total monedas|Monete totali
Total tarjetas|Totale carte
Total otras formas de pago|Totale altri metodi di pagamento
Caja Inicial:|Contanti iniziali:
Num total de operaciones de este terminal|Numero totale di operazioni di questo terminale
Num total operaciones otras formas pago|Num totale operazioni altre forme di pagamento
Num total operaciones tarjeta|Operazioni con le schede numeriche
Num total operaciones contado|Totale transazioni contate
Max. 20|Max. 20
Número de tipos de moneda a utilizar:|Numero di tipi di valuta da utilizzare:
Seleccione las monedas en circulacion de su pais|Seleziona le valute in circolazione del tuo paese
Tipo 20|Digitare 20
Nota: Esta opcion solo esta pensado para aquellos clientes que en su pais el valor de sus monedas es diferente al establecido para la zona Euro.|Nota: questa opzione è intesa solo per quei clienti che nel loro paese il valore delle loro valute è diverso da quello stabilito per la zona Euro.
Importe a Retirar|Importo da prelevare
Retiradas|ritiri
TELEF|TELEF
Borrando|obliterante
Hora Reserva|Tempo di riserva
Nro comensales|Nessun commensali
Todos|tutto
Cena|cena
Almuerzo|pranzo
Desayuno|prima colazione
MESAS =|TABELLE =
H O R A S|H O R A S
Seleccione Horario|Seleziona orario
*Clic para seleccionar salon|* Clicca per selezionare la stanza
R e s e r v a s|R e s v r s a
Diseñar Plantilla reserva|Design modello libro
Nueva Reserva|Nuova Riserva
Hora de Reserva|Tempo di prenotazione
Nro de Comensales|Numero di Diners
Teléfono|telefono
* Click en la columna de telefono para ver la direccion|* Fare clic sulla colonna del telefono per visualizzare l'indirizzo
Resultado de la Búsqueda|Risultato della ricerca
Movil|Movil
C. Postal|C. postale
Limpiar|pulito
DNI|DNI
Puerta:|porta:
Fijo / Movil|Risolto / mobile
Piso:|piano:
C. Postal:|C. postale:
Número:|il numero:
Email:|e-mail:
Modificar Datos|Modifica dati
Nuevo Cliente|Nuovo cliente
Activar Precios para este terminal de venta|Attiva i prezzi per questo terminale di vendita
Crear nueva o modificar una lista de precios existente|Crea nuovo o modifica un listino prezzi esistente
Listas de Precios|Listini dei prezzi
Listas activa en este terminal|Elenchi attivi in ​​questo terminale
Listas de precios no activa|Listini prezzi non attivi
La lista de precios que ha seleccionado esta fuera del rango actual|Il listino prezzi selezionato non rientra nell'intervallo corrente
Nombre (click para seleccionar/desactivar)|Nome (clicca per selezionare / disattivare)
activa|attivo
Fecha Alta|Data alta
Prod. en Lista|Prod. In elenco
Codigo Precio|Codice Prezzo
C. P.|C. P.
Cif / Dni|CIF / Dni
Realizando cambios|Fare cambiamenti
alturapanel|alturapanel
Los mismos pasos 1, 2 para margen comercial o precio de venta.|Gli stessi passaggi 1, 2 per margine commerciale o prezzo di vendita.
* Clic sobre el impuesto que desea cambiar|* Clicca sulla tassa che vuoi cambiare
De:|di:
Cambio el valor de los impuestos|Cambia il valore delle tasse
Deseo cambiar|Voglio cambiare
a:|un:
Nro. de Productos|No. di prodotti
2.-Luego seleccione el proveedor o seleccione la opcion todos.|2.-Quindi selezionare il fornitore o selezionare l'opzione tutto.
Con redondeo|Con arrotondamento
Sin redondeo|Senza arrotondamenti
Todos los productos|Tutti i prodotti
Productos del Proveedor|Prodotti del fornitore
Coste|costo
Cambio de Coste / Precio|Cambio di costo / prezzo
1.-Si desea aumentar el coste, solo debe ingresar el porcentaje en la caja del mismo.|1.-Se vuoi aumentare il costo, inserisci la percentuale nella casella.
Recuerde que este proceso es irreversible. Confirme y  verifique los porcentajes que está aumentando.|Ricorda che questo processo è irreversibile. Conferma e verifica le percentuali che stanno aumentando.
Este proceso automatiza el aumento de precio, margen comercial y coste de los productos.|Questo processo automatizza l'aumento di prezzo, margine commerciale e costo dei prodotti.
Aumento de Precios|Aumento dei prezzi
Nombre Servidor SQL Server|Nome server Server SQL
Utilizar  SQL   Server . . . . . |Utilizzare SQL Server . . . .
UTILIZAR SQL SERVER|USA SQL SERVER
Más Información|Maggiori informazioni
Dirigido para aquellas empresas con volumenes de datos altos o muchas interacciones simultaneas soporta varios PC conectados en red sin problemas de concurrencias y trafico de datos. (si este es su caso nuestro programa funciona perfectamente con este ges|Diretto per le aziende con elevati volumi di dati o molte interazioni simultanee, supporta diversi PC in rete senza problemi di concorrenza e traffico dati. (Se questo è il tuo caso, il nostro programma funziona perfettamente con questo ges
SQL SERVER|SQL SERVER
Indicado para empresas con volumen de datos bajos 1 o 2 PC en red.|Indicato per aziende con basso volume di dati 1 o 2 PC in rete.
ACCESS|ACCESSO
El Tipo de Base De Datos Que Su Negocio Necesita|Il tipo di database esigenze aziendali
Pasar a la version Basica o Completa|Vai alla versione di base o completa
Configure los Horarios de su establecimiento|Configura gli orari del tuo stabilimento
Label2|Label2
a |a
El Horario del Establecimiento es:|Il programma di costituzione è:
El Horario de Cocina es:|Il programma della cucina è:
Seleccione el Horario del Establecimiento|Seleziona il programma di stabilimento
Seleccione el Horario de Cocina|Seleziona il programma di cucina
4.- Solo le recomendamos que contrate este servicio y utilice esta opcion si solo si su empresa verdaderamente lo necesita, por nuestra experiencia el 90% de los usuarios de Puntos de Venta del sector retail no necesitan tener esta base de datos instalada|4.- Ti consigliamo di assumere questo servizio e utilizzare questa opzione solo se la tua azienda ne ha davvero bisogno, dalla nostra esperienza il 90% degli utenti di Punti vendita nel settore retail non hanno bisogno di avere questo database installato
3.- Tiene que indicarnos los nombre de los usuarios que utilizaran el programa para crear los usuarios en la base de datos. (este servicio incluye 3 usuarios si desea mas usuarios el coste es de 5 Euros por cada uno)|3.- Devi indicare i nomi degli utenti che useranno il programma per creare gli utenti nel database. (questo servizio include 3 utenti se vuoi più utenti il ​​costo è di 5 euro ciascuno)
2.- Tiene que tener instalado el TeamViewer para que un tecnico pueda conectar a instalar la BD y dejarle el programa funcionando en Sql Server|2.- È necessario aver installato TeamViewer in modo che un tecnico possa connettersi per installare BD e lasciare il programma in esecuzione su Sql Server
1.- Este servicio tiene un coste de 75 Euros + Iva|1.- Questo servizio ha un costo di 75 euro + IVA
Si desea utilizar el programa con Sql Server un tecnico de nuestra empresa se lo puede instalar. Pasos que tiene que tomar en cuenta.|Se si desidera utilizzare il programma con Sql Server, è possibile installarlo da un tecnico della nostra azienda. Passi che devi prendere in considerazione.
Requisitos Para Usar Sql Server|Requisiti per l'utilizzo di SQL Server
Numero de Ventas Menores A: |Numero di vendite secondarie A:
Seleccione de que terminal quiere obtener la información|Seleziona da quale terminale desideri ottenere le informazioni
Servicios|servizi
Completo|pieno
Total General|Totale generale
Total Gastos|Spese totali
C. Inicial|C. Iniziale
Total Retiradas|Prelievi totali
Totalizado por Forma de Pago|Totalizzato dal modulo di pagamento
Ventas Generales por Dia|Vendite generali al giorno
Esta Forma de Pago es de tipo Tarjeta|Questo metodo di pagamento è di tipo Carta
Nueva Observación|Nuova osservazione
comensal|commensale
Observacion|osservazione
estado|stato
idenvio|idenvio
Seleccione la observacion que desea eliminar del panel de arriba|Seleziona l'osservazione che vuoi rimuovere dal pannello in alto
Observaciones a Cocina|Osservazioni alla cucina
Posicion|posizione
Escriba la nueva observacion|Scrivi la nuova osservazione
Eliminar Observación|Elimina l'osservazione
Seleccione Mesa Destino|Seleziona tabella di destinazione
Total Cuenta Origen|Total Account Origin
Seleccione Mesa A Juntar|Seleziona tabella per partecipare
Seleccione Salon Destino|Seleziona Salone di destinazione
Seleccione Salon|Seleziona Salon
Pedidos en Reserva|Ordini in Riserva
Fecha Seleccionada|Data selezionata
Total Reservas|Prenotazioni totali
Reservas Activas|Riserve attive
N. Pedido|N. Ordine
Fecha Entrega|Data di consegna
Hora Entrega|Tempo di consegna
Observaciones|osservazioni
Fecha de Entrega|Data di consegna
Hora de Entrega|Tempo di consegna
Contraseña = |Password =
Zona|zona
Venta Original|Vendita originale
Total Cuenta Parcial|Conto parziale totale
Escriba la clave de gerencia|Inserisci la chiave di gestione