Configuracion Inicial|Configuração inicial
Seleccione el Idioma / Select the Language|Selecione o idioma / selecione o idioma
Color|Cor
Movimiento|Movimento
Otros|Outros
Indiquenos desde que sitio ha descargado este programa|Indique de qual site você baixou este programa
Correo Electronico|Correio eletrônico
2 decimales|2 decimais
0 decimales|0 decimais
Seleccione el Numero de Decimales|Selecione o número de decimais
Seleccione el Impuesto|Selecione o imposto
Seleccione su Bandera|Selecione seu sinalizador
Seleccione la Moneda|Selecione a moeda
Seleccione el Pais|Selecione o país
Nombre de Empresa|Nome de empresa
Continuar|Continue
Programa|Programa
Continuar / Continue|Continue / Continue
Este boton le permitira cambiar la configuracion regional|Este botão permitirá que você altere as configurações regionais
Con este boton cambiara el tamaño de la ventana.|Com este botão, você irá alterar o tamanho da janela.
Con este boton podra ver datos de su licencia|Com este botão, você pode ver seus dados de licença
Este boton le servira para cambiar el idioma|Este botão servirá para mudar o idioma
Con este boton cambiara el color de la pantalla|Com este botão, a cor da tela mudará
Programa protegido por los derechos de propiedad intelectual en Marcas y Patentes en cuanto a contenido y diseño.|Programa protegido por direitos de propriedade intelectual em marcas e patentes em termos de conteúdo e design.
Madrid - España|Madrid Espanha
Tpv|Tpv
** Bienvenido **|** Bem-vindo **
Salir|Saída
Caja Entradas|Caixa de bilhetes
Seleccione Su Opcion|Selecione sua opção
Caja Ropero|Caixa de guarda-roupa
Comprar|Comprar
¡Tiempo Limitado!|Tempo Limitado!
6 Comprados|6 comprado
Horas:|Horas:
Cod Promocion: XXXXX|Promoção de bacalhau: XXXXX
Tiene un descuento de|Tem um desconto de
Precios|Preços
* Recuerde que para poder tener asistencia telefonica tiene que tener contratado la version Completa, en caso contrario haga su consulta directamente desde el programa.|* Lembre-se que, para ter assistência por telefone, você deve ter a versão completa, caso contrário, consulte diretamente do programa.
* Consulte nuestra pagina web, para confirmar los precios que es posible que hayan sufrido algun cambio|* Confira nosso site, para confirmar os preços que podem ter sofrido alguma alteração
<Tipo de Licencia>|<Tipo de licença>
Estoy utilizando una licencia|Estou usando uma licença
Diferencias entre tipos de licencia|Diferenças entre tipos de licença
Pasar de la version Gratuita a la Basica|Alternar da versão gratuita para a versão básica
Promociones / Envio Email|Promoções / Email
Admisitracion Permisos|Autorizações de admissão
Tipos de licencia|Tipos de licença
Conectar en Red|Conecte-se na rede
Activar Gratis la version Basica|Ativar a versão básica gratuitamente
Registrar|Cadastre-se
<Terminal>|<Terminal>
Acerca de|Sobre
Asistencia|Assistência
Configuracion|Configuração
Listados|Listagens
Caja|Box
Conexion con dispositivo movil - android|Conexão com dispositivo móvel - android
Niveles de Acceso|Níveis de Acesso
Almacenes|Armazéns
Mantenimiento|Manutenção
Actualizaciones Activadas|Atualizações Ativadas
Tpv 123 Hosteleria (Version: 8.5.1)|Tpv 123 Hosteleria (Versão: 8.5.1)
Serie: XXX|Série: XXX
Licencia: XXX|Licença: XXX
PROGRAMA REGISTRADO|PROGRAMA REGISTRADO
nombre restaurante|nome do restaurante
Tpv 123 Hosteleria|Tpv 123 Hospitalidade
ADVERTENCIAS IMPORTANTES|AVISOS IMPORTANTES
- El desconocimiento de estas condiciones no le exime del cumplimiento de las mismas.|- Ignorância dessas condições não isenta você de cumpri-las.
- Solo los clientes con la version COMPLETA tienen incluida la asistencia telefonica|- Somente clientes com a versão COMPLETA têm assistência por telefone incluída
---- En la modalidad COMPLETA, realizando un pago anual, ademas de las opciones incluidas en la version BASICA, tendra derecho a la asistencia de forma telefonica.|---- No modo COMPLETO, fazendo um pagamento anual, além das opções incluídas na versão BASIC, você terá direito a assistência por telefone.
---- En la modalidad BASICA, con una reducida cuota anual usted tendra habilitada las opciones del programa que le permitiran realizar todas gestiones necesarias para su negocio, para mayor detalle recuerde consultar la opcion de Tipos de Licencia.|---- No modo BASICA, com uma taxa anual reduzida, você terá habilitado as opções do programa que lhe permitirá realizar todas as etapas necessárias para o seu negócio, para mais detalhes, lembre-se de consultar a opção Tipos de licença.
Si decide utilizar la version GRATUITA recuerde que tiene algunas limitaciones, consulte la opcion de Tipos de Licencia para una descripcion mas detallada de la version GRATUITA, BASICA y COMPLETA.|Se você decidir usar a versão FREE, lembre-se que ela tem algumas limitações, veja a opção Tipos de Licença para uma descrição mais detalhada da versão FREE, BASIC e COMPLETE.
---- En la modalidad GRATUITA, durante los primeros 90 dias usted podra probar y trabajar con la version BASICA, pasado ese periodo podra volver a la version gratuita o pasar a la version BASICA o COMPLETA. Recuerde que esta version GRATUITA  es para empr|---- No modo FREE, durante os primeiros 90 dias você pode tentar trabalhar com a versão BASIC, após esse período você pode retornar para a versão gratuita ou ir para a versão BASIC ou COMPLETE. Lembre-se que esta versão gratuita é para negócios
- La empresa Tpv 123 - Gratuito no es responsable si el cliente formatea el equipo o es atacado por algun tipo de virus que provoque la perdida de informacion o de licencia.|- A empresa Tpv 123 - Gratuito não se responsabiliza se o cliente formatar o equipamento ou se for atacado por algum tipo de vírus que cause a perda de informação ou licença.
- Tpv 123 - Gratuito recomienda la compra, para el buen funcionamiento del programa, de una impresora de tickets EPSON/SAMSUNG/Star o cualquier modelo de impresora, siempre que se instale junto con los drivers de dicha impresora. (Tipo de conexion recomen|- O Tpv 123 - Free recomenda a compra, para o bom funcionamento do programa, de uma impressora de bilhetes EPSON / SAMSUNG / Star ou de qualquer modelo de impressora, desde que seja instalado em conjunto com os drivers da impressora. (Tipo de conexão recomen
- Este es un programa estandar, no se hacen modificaciones a medida o personalizaciones, nuestros clientes en version BASICA y COMPLETA si pueden sugerirnos algunos cambios que nosotros sin ningun coste añadido incluiremos en siguientes versiones.|- Este é um programa padrão, sem modificações ou personalizações personalizadas, nossos clientes nas versões BASIC e COMPLETE, se puderem sugerir algumas alterações que serão incluídas sem custo adicional nas versões a seguir.
- Si usted esta utilizando la version GRATUITA y necesita algun tipo de asistencia recuerde que tiene que contratar la version BASICA o COMPLETA dependiendo de su incidencia.|- Se você estiver usando a versão GRATUITA e precisar de alguma ajuda, lembre-se de contratar a versão BASIC ou COMPLETE, dependendo da sua incidência.
Al instalar este programa,usted acepta las siguientes condiciones:|Ao instalar este programa, você aceita as seguintes condições:
CONDICIONES DE USO DEL PROGRAMA|CONDIÇÕES DE UTILIZAÇÃO DO PROGRAMA
Promociones Fast Food|Promoções de fast food
Zonas|Areas
SubFamilias|Subfamílias
Productos Elaborados|Produtos Processados
Productos|Produtos
Familias|Famílias
Varios Precios|Vários preços
Formas de Pago|Formas de pagamento
Empleados|Funcionários
Clientes|Clientes
Proveedores|Fornecedores
Aceptar|Aceitar
Cancelar|Cancelar
Eliminar|Excluir
Modificar|Modificar
Nuevo|Novo
No Movimiento|Sem movimento
Productos relacionados con el proveedor:|Produtos relacionados ao fornecedor:
Dia de Visita:|Dia da visita:
Número de Cuenta:|Numero de conta:
Nombre del Banco|Nome do banco
Dia de Pago:|Dia de pagamento:
Forma de Pago:|Forma de pagamento:
Observaciones:|Observações:
Correo Electrónico:|Correio eletrônico:
Móvil / Celular:|Celular / Celular:
Teléfono:|Telefone:
Dirección:|Endereço:
Población:|População:
Código Postal:|Código postal:
Provincia:|Província:
País:|País:
DNI / CIF|DNI / CIF
Contacto:|Contato:
Nombre|Nome
Gestion de Proveedores|Gestão de Fornecedores
Lista de Proveedores|Lista de provedores
Ver Ingredientes|Veja os Ingredientes
Ver Productos Venta|Veja a Venda de Produtos
Zona:|Zona:
    Buscar Por Nombre:|    Procurar por nome:
Codigoproducto|Produto Codigo
Barra|Barra
Cocina|Cozinhar
Ambos|Ambos
situaciongrid|situaciongrid
Posicion  en Pantalla:|Posição da tela:
Ingredientes|Ingredientes
Producto para Venta|Produto à Venda
Mostrar en Pantalla de Caja:|Mostrar na tela da caixa:
Precio de Venta:|Preço de venda:
Impuesto:|Imposto:
grid_ingredientes|grid_ingredientes
grid_productosventas|grid_productosventas
Descripcion Numerica:|Numerica description:
Seleccionar Color:|Selecione a cor:
Insertar Imagen|Inserir imagem
Tipo de Producto:|Tipo de produto:
Producto preparado en:|Produto preparado em:
Coste:|Custo:
Stock Actual:|Estoque Atual:
Stock Minimo:|Estoque Mínimo:
Proveedor:|Provedor:
Codigo de Barras:|Código de barras:
Unidades de medida:|Unidades de medida:
Nombre del Producto:|Nome do produto:
Gestion de Productos|Gestão de produtos
Buscar|Pesquisar
Resultados de la Busqueda|Resultados da pesquisa
panel de busqueda de clientes|painel de pesquisa do cliente
Buscar Clientes|Pesquisar clientes
** DOBLE CLIC EN EL CLIENTE DESEADO|** CLIQUE DUPLO NO CLIENTE DESEJADO
Rellene algun campo para la busqueda|Preencha alguns campos para a pesquisa
DNI/ CIF|DNI / CIF
Tlf Movil|Telefone móvel
Telefono|Telefone
Email|Email
Provincia|Province
Poblacion|População
Apellidos|Apelido
CP|CP
Codigo Cliente|Código do cliente
situacion|Situação
Descuento %|% De desconto
historico ventas|vendas históricas
datos|dados
Lista Ultimos 50 Clientes|Última lista de 50 clientes
Puerta|Porta
Numero|Número
Piso|Chão
Direcccion|Direção
Nombre *|Nome *
situacion buscar|pesquisa de situação
Gestion de Clientes|Gestão de clientes
Familia Tipo Menu Combo|Menu Família Tipo Combo
Familia Tipo Menu|Menu Tipo de Família
Familia Generica|Família Genérica
Gestion de Familias|Gestão Familiar
Clic sobre la familia para ver mas detalles|Clique na família para ver mais detalhes
Lista de Familias|Lista de Famílias
*Pulse en la familia para ver los productos agregados a la misma|* Clique na família para ver os produtos adicionados a ela
Seleccione el tipo de familia|Selecione o tipo de família
Lb_stopanelproductos|Lb_stopanelproducts
Esta familia no tiene productos relacionados|Esta família não tem produtos relacionados
lista productos|listar produtos
Clic en el producto que desee incluir en su familia|Clique no produto que você deseja incluir em sua família
Lista de Productos |Lista de Produtos
Añadir Productos|Adicionar produtos
Tipo de Familia:|Tipo de Família:
Label5|Label5
datos generica|dados genéricos
datos familia generica|dados genéricos da família
Imagen|Image
Datos de la Familia|Dados da família
Mostrar en Caja |Mostrar na caixa
Posicion en Pantalla|Posição da tela
Descripcion Numerica|Numerica description
Productos Incluidos|Produtos Incluídos
panel menu familia|família de menu do painel
Producto incluido en otra familia|Produto incluído em outra família
Productos Tercer Plato/ Postre|Terceiro Prato / Sobremesa
Productos Segundo Plato|Segunda placa de produtos
Productos Primer Plato|Produtos de Primeira Placa
Añadir Postre|Adicionar Sobremesa
Añadir Segundo|Adicionar segundo
Añadir Primero|Adicionar primeiro
Impuesto|Imposto
Precio de Venta|Preço de venda
tipo|digitar
NO BORRAR|NÃO APAGUE
situacion paneles|painéis de situação
Añadir + Productos a la SubFamilia|Adicionar + produtos à subfamília
Clic en el producto que desee incluir en el subproducto|Clique no produto que você deseja incluir no subproduto
Familia a la que pertenece|Família a que pertence
datos subfamilia|dados da subfamília
Datos de la SubFamilia|Dados da Subfamília
SubFamilias Existentes|Subfamílias existentes
Num S.S.:|Num S.S .:
Repartidor:|Revendedor:
Apellidos:|Apelido:
Color en Caja:|Cor na caixa:
Número de  Cuenta:|Numero de conta:
Nombre  del Banco:|Nome do banco:
Foto:|Foto:
Correo  Electrónico:|Correio eletrônico:
NIF/ CIF:|NIF / CIF:
Nombre:|Nome:
Lista de Empleados|Lista de funcionários
Gestion de Empleados|Gestão de Empregados
*clic para ver datos del producto|* clique para ver os dados do produto
top grid|grade superior
Sirve para que en lugar de que  aparezca una imagen en el boton  del producto aparezca un numero.|Serve para que, em vez de aparecer uma imagem no botão do produto, apareça um número.
alturacandidadingredientes|heightcandityingredients
Es el lugar donde queremos que se  muestre el producto en caja cuando hacemos clic sobre su familia.|É o lugar onde queremos mostrar o produto na caixa quando clicamos na sua família.
nombreproducto|nome do produto
Codigo|Code
CantidaddeIngredientes|Quantidade de Ingredientes
Cantidad|Quantidade
Ingredientes Incluidos en el Producto: |Ingredientes Incluídos no Produto:
Ver Datos Completos|Ver dados completos
¿cuantos|Quantos
sto ingredientes|sto ingredientes
Producto Elaborado|Produto processado
Producto preparado en|Produto preparado em
Descripcion  Numerica:|Numerica description:
situacion izquierda|situação da esquerda
situacion derecha|situação certa
alturagrid|alturagrid
Seleccione el producto o el ingrediente a utilizar|Selecione o produto ou ingrediente a usar
Ver Productos|Veja os produtos
Gestion de Productos Elaborados|Gerenciamento de produtos processados
Ver Ingredientes Incluidos|Veja os ingredientes incluídos
Añadir Producto|Adicionar produto
Nuevo Precio|Novo Preço
Precio Actual|Preço atual
Añadir Nuevos Productos|Adicionar novos produtos
Producto|Produto
Precio Original|Preço Original
Precios Validos entre los siguientes dias y horas|Preços válidos entre os dias e horas seguintes
Hora Hasta|Hora até
Hora Desde|Tempo De
Fecha Hasta|Data até
Fecha Desde|Data de
Nombre de la lista|Nome da lista
SITUACION DE LOS PANELES|SITUAÇÃO DOS PAINÉIS
Id lista|Lista de identificação
Fecha de Alta|Data de alta
Desde|De
Hasta|Up
Horario Desde|Programar a partir de
Horario Hasta|Agendar Up
Ver Lista|Ver lista
Lista de Precios Existentes|Lista de preços existente
Volver Lista de Precios|Lista de Preços Atrás
Lista de Precios|Lista de preços
Productos de Barra|Produtos da Barra
Productos de cocina|Produtos de cozinha
Esta zona la voy a utilizar para|Eu vou usar essa área para
Zonas Existentes|Áreas Existentes
Zonas de Impresion|Áreas de Impressão
Diseño|Design
Otro Terminal|Outro terminal
Reservada|Reservado
Ocupada|Ocupado
Libre|Grátis
Panel Mesas|Tabelas de Painéis
Mesas|Tabelas
Diseño Salon|Salon Design
Reservas|Reservas
Salones|Quartos
Reserva|Reserva
Total|Total
Tablet Activada|Tablet ativado
Visor Pedidos|Visualizador de pedidos
Bit|Pouco
Pedido Telefonico|Ordem de telefone
Envio|Grátis
Juntar Cuentas|Junte-se a contas
SALON|SALÃO
EMPLEADO|EMPREGADO
codigoempleado|código do empregado
PEDIDO|PEDIDO
H. INICIO|H. HOME
MESA|MESA
Cant.|Não posso
Precio|Preço
Primero|Primeiro
Segundo|Segundo
Postre|Sobremesa
Desc|Desc
Num_Factura|Num_Factura
Recargo|Sobretaxa
Producto de Menu|Produto do cardápio
Menu|Cardápio
Codigo del Menu|Código do Menu
Servido|Servido
Tipo de Impuesto|Tipo de imposto
Cod Empleado|Empregado de bacalhau
codigo Familia|Código da família
Indice|Índice
Cod. Prod.|Cod. Prod.
Orden Menu|Order Menu
ZonaImpresion|Área de Impressão
BEBIDAS/ POSTRES|BEBIDAS / SOBREMESAS
PRIMER PLATO|PRIMEIRO PRATO
SEGUNDO PLATO|SEGUNDO PRATO
situacion panel producto|situação do painel do produto
Opciones|Opções
Cobrar|Cobrar
Abrir  Cajetin|Cajetin aberto
Preticket|Pretzel
Enviar a cocina|Enviar para a cozinha
Borrar Venta|Excluir venda
Observ. Pedido|Eu observei Ordem
Crear/Modificar Salones|Criar / Modificar Salas
Diseño de Salones|Design de Salas
Elementos para  el diseño|Elementos de design
Posicion del objeto/mesa|Posição do objeto / mesa
Eliminar Mesa|Remover Tabela
Eliminar Objeto|Excluir objeto
Guardar Numero|Salvar número
Numero Mesa|Tabela Numérica
Eliminar Diseño Salon|Remover Design Salon
Boton Pulsado|Botão Pulsado
Objeto Pulsado|Objeto Pulsado
Esta diseñando el:|Está projetando o:
Alta Salones/ Barra|Salões altos / Bar
Lista de Salones - Barras|Lista de Quartos - Bares
Recargo:|Sobretaxa:
Posicion En Pantalla:|Posição da tela:
Color Salon|Salão de cor
Imagen Mesas|Tabelas de Imagem
Nro de Mesas:|Nº de tabelas:
Imagen Salon|Imagem do salão de beleza
Cambiar Idioma / Change Language|Alterar idioma / alterar idioma
Base De Datos|Base de dados
Contraseña Director|Senha do diretor
Importar Imagenes del Servidor|Importar imagens do servidor
Permisos Usuario|Permissões do usuário
Importar Datos|Dados de importação
Cierre Año|Próximo ano
Envio Informes|Relatórios de envio
Conexion en Red|Conexão de rede
Aumento Precio|Aumentar Preço
Horario|Horário
Diseño Ticket / Factura|Design do Bilhete / Fatura
Cajetin|Cajetin
Impresoras|Impressoras
Copia de Seguridad|Copia de segurança
Configuracion Regional|Configurações Regionais
Datos de la empresa|Dados da empresa
situacionpaneles|situacionpaneles
Esta a punto de restaurar una copia de seguridad, recuerde que este proceso es irreversible y cambiara la base de datos con la que trabaja en estos momentos por la seleccionada |Você está prestes a restaurar um backup, lembre-se de que esse processo é irreversível e mudará o banco de dados com o qual você está trabalhando atualmente para o selecionado
Hacer Copia de Seguridad|Faça backup
Restaurar Copia de Seguridad|Restaurar Backup
Administracion Permisos|Administração de permissões
Nro. de copias del preticket|Nº de cópias pré-bilhete
Nro. de copias del ticket|Nº de cópias do bilhete
Centrado|Centrado
OFF|OFF
ON|ON
Enviar Confirmacion Reserva|Enviar reserva de confirmação
Enviar email al director / cierre caja|Enviar email para o diretor / fechar caixa
Realizar cierre caja ciego|Execute fechamento caixa cega
Pedir Contraseña Al Entrar Al Programa|Solicitar senha ao entrar no programa
Permisos Usuarios|Permissões de usuários
Pedir contraseña para las modificaciones / eliminaciones / descuentos ... (Para todos los empleados)|Pedir senha para modificações / exclusões / descontos ... (para todos os funcionários)
Pedir Contraseña Apertura de Cajetin|Solicitar senha Cajetin Opening
Pedir Contraseña Al Entrar Caja|Pergunte a senha ao entrar na caixa
Pedir Empleado Al Entrar Caja|Pergunte ao empregado ao entrar na caixa
Activar Opciones|Ativar Opções
Pedir Contraseña|Pergunte a senha
Pedir Empleado X Cada Venta|Pergunte para o empregado X cada venda
Utilizar Caja Rapida|Use Quick Box
Entrar en modo Direccion|Entre no modo Endereço
¿Ha olvidado su contraseña?|Você esqueceu sua senha?
No ha seleccionado ningun empleado|Você não selecionou nenhum funcionário
Ingrese su clave:|Digite sua senha:
SELECCIONE EL EMPLEADO|SELECIONE O EMPREGADO
Nombre de la Empresa|Nome da empresa
Ingrese el nro. de percha|Digite o número de cabide
lb-_Empleado|lb-_Empregado
Cambio Precio|Alterar preço
Cierre De Caja|Fechamento da caixa
Imprimir Resguardo|Imprimir Resguardo
Imprimir Ticket|Bilhete de impressão
Abrir Cajetin|Cajetin aberto
Terminar Venta|Venda final
Importe Total Prendas|Quantidade Total de Vestuário
Entrega cliente|Entrega ao cliente
Devolucion|Retorno
Venta Anterior|Venda anterior
Nro Prendas|Não. Vestuário
Caja - Ropero|Box - Guarda-Roupa
Entrada Seleccionada|Entrada selecionada
Entrada + consumicion|Entrada + consumo
Entrada Seleccionada:|Entrada selecionada:
Seleccion De Entradas|Seleção de ingressos
Nombre del Visor:|Nome do visualizador:
Utilizar Visor|Use o Viewer
Eliminar Impresoras de este teminal|Remover impressoras deste terminal
La impresora se ha dado de alta correctamente|A impressora registrou com sucesso
Seleccione la celda en la interseccion de la impresora y la zona que quiere asociar|Selecione a célula na interseção da impressora e a área que você deseja associar
Configuracion de Impresoras|Configuração da impressora
Gestion de Impresoras|Gerenciamento de Impressora
Reenvio de Pedidos A cocina / Barra|Encaminhamento de Pedidos para Cozinha / Bar
* click en la linea que desea reimprimir|* clique na linha que você deseja reimprimir
Zona Impresion|Zona de impressão
Hora|Hora
numPedido|numPedido
Fecha|Data
enviado|enviado
Detalles del Pedido|Detalhes da Ordem
Reenviar|Reenviar
NumPedido =|OrderNum =
Guardar|Salvar
Descuento a aplicar|Desconto para aplicar
lblCliente|lblClient
Terminar Venta <F12>|Acabamento de Venda <F12>
Descuento|Desconto
Buscar Cliente|Pesquisar no cliente
Cambio|Alterar
Cliente entrega Efectivo|Cliente de entrega em dinheiro
Cliente paga con Tarjeta|Cliente paga com cartão
Formato de Impresion|Formato de impressão
Formato A4|Formato A4
Formato A5|Formato A5
Tamaño 10 cm.|Tamanho 10 cm.
Imprimir factura|Imprimir fatura
SubTotal|Subtotal
Propina|Dica
Enviar ticket Correo Electronico|Enviar ticket E-mail
Cerrar Venta|Fechar venda
Imprimir en Cocina|Imprimir na cozinha
V E R  T I C K E T|V E R I I C K E T
Tipo de venta|Tipo de venda
Factura|Fatura
Boleta Formato Ticket|Bilhete de formato de bilhete
Ultima Venta|Última venda
Diseño de salon|Design de salão de beleza
Eliminar Venta Ya Cobrada|Excluir venda já coletada
Cobro Parcial|Colecção Parcial
Reservas de Mesas|Reservas de mesa
Listados Caja|Caixa de Listagens
Retirada de Caja|Retirada de dinheiro
Gastos del Dia|Despesas do dia
Activar Precios para este Terminal|Ativar Preços para este Terminal
Reimpresion Ticket|Reimprimir Bilhete
Modificacion de Tickets|Modificação de ingressos
Conteo y cierre de caja|Contagem e fechamento de dinheiro
situacion panel opciones|opções de situação do painel
panel_opciones de caja|panel_options
CONFIGURACION OPCIONES CAJA|OPÇÕES DE CAIXA DE CONFIGURAÇÃO
Regresar al idioma original|Retornar ao idioma original
¿Confirma que desea eliminar el siguiente registro?|Tem certeza de que deseja excluir o próximo registro?
Idiomas|Idiomas
Usted ha seleccionado|Você selecionou
Ninguno|Nenhum
¿Seleccione el Idioma?|Selecione o idioma?
Texto Traducido|Texto traduzido
Texto Original|Texto original
id|id
Texto|Texto
Traduccion|Tradução
lineas sin traducir|linhas não traduzidas
Click sobre la linea para añadir una traduccion|Clique na linha para adicionar uma tradução
Click sobre la linea para modificar la traduccion|Clique na linha para modificar a tradução
Texto sin traducir|Texto não traduzido
Condiciones|Condições
Registro de Licencias|Registro de Licenças
Acerca de ...|Sobre ...
TPV Gratuito|POS grátis
B. Aires - Argentina|B. Aires - Argentina
D. F. - Mexico|D. F. - Mexico
Santiago de Chile|Santiago do Chile
Lima - Peru|Lima Peru
Costa Rica|Costa Rica
Puerto Rico|Porto Rico
Miami - Florida|Miami - Flórida
Bogota - Colombia|Bogotá Colômbia
Mantenimiento registrado hasta:|Manutenção registrada até:
Fecha de Caducidad:|Data de validade:
Fecha de Instalacion:|Data de Instalação:
TPV Gratuito, Departamento de Desarrollo|POS gratuito, departamento de desenvolvimento
Ultima actualizacion: XXX|Última atualização: XXX
Fecha de creacion:  XXX|Data de criação: XXX
Proyecto: Tpv 123, Version: XXX|Projeto: Tpv 123, Versão: XXX
Paseo de Europa 7, (S.S. de los Reyes - Madrid -España)|Caminhada da Europa 7, (S.S. de los Reyes - Madrid-Espanha)
Buenos Aires - Argentina|Buenos Aires, Argentina
E-mail: compras@tpvgratuito.com   www.tpvgratuito.com|E-mail: compras@tpvgratuito.com www.tpvgratuito.com
Servicio de asistencia:|Helpdesk:
Reg. Anual|Reg anual
Usted está utilizando una licencia:|Você está usando uma licença:
SolverMedia|SolverMedia
SolverMedia, Departamento de Desarrollo|SolverMedia, Departamento de Desenvolvimento
Fecha de creacion: XXX|Data de criação: XXX
Proyecto: Servidor Net, Version: XXX|Projeto: Net Server, Versão: XXX
No hay datos para ser mostrados|Não há dados a serem mostrados
Listado de Empleados|Lista de funcionários
Listado de Familias|Lista de Famílias
Listados Generales|Listagens gerais
Ventas NCF Rep. Dominicana|Vendas NCF Rep. Dominicana
Ventas con Promociones|Vendas com Promoções
Productos Bajo Minimo|Mínimo inferior de produtos
Reimprimir Factura - Ticket|Reimprimir fatura - bilhete
Ventas x Clientes|Vendas x Clientes
Imprimir Letreros  y  Etiquetas |Imprimir sinais e etiquetas
Estadisticas|Estatísticas
Valoracion Stock x Proveedores|Estoque de avaliação x Fornecedores
Valoracion Stock General|Avaliação geral de ações
Listado de Proveedores|Lista de provedores
Listado de Clientes|Lista de clientes
Listado de Productos|Lista de Produtos
Servicios a Domicilio|Serviços Domésticos
Consumo de Platos Menu|Menu de Consumo de Prato
Reservas x Dia|Reservas x dia
Pedidos Realizados a Proveedor|Pedidos feitos ao fornecedor
Empleado del Mes|Empregado do mês
Estadistica x Repartidor|Estatísticas x Dealer
Retiradas Empleados|Empregados retirados
Relacion Envios Cocina contra Ventas|Relacionamento de Transporte Cozinha vs. Vendas
Formato Din-A4|Formato Din-A4
Formato Ticket|Formato do bilhete
Total Diario de Retiradas|Retirada diária total
Ventas x Zonas|Vendas x áreas
Caja Total x Dias|Caixa Total x Dias
Gastos de Caja|Despesas em dinheiro
Descuentos Realizados|Descontos feitos
Ventas en el mes (Acumulado x Horas)|Vendas no mês (acumulado x horas)
Reservas Hora/Dia /Mes|Hora de Reservas / Dia / Mês
Ventas x Empleados|Vendas x funcionários
Impuestos Repercutidos|Impostos Tributados
Gastos|Despesas
Relacion de Propinas|Tip Ratio
Ventas x Menus|Vendas x Menus
Resumen Contable de Facturas|Resumo da contabilidade da fatura
Productos mas Vendidos|Produtos Mais Vendidos
Productos Sin Ventas|Produtos sem vendas
Ventas x Horas|Vendas x horas
Resumen de Venta x Empleados|Resumo da venda x funcionários
Ventas Detalladas x Empleados|Vendas detalhadas x funcionários
Ventas Eliminadas y Descuentos|Vendas Excluídas e Descontos
Ventas x Zonas -Totalizado x Productos|Vendas x Áreas -Totalizadas x Produtos
Ventas Generales x Dia|Vendas Gerais x Dia
Ventas x Familias|Vendas x Famílias
Ventas x Zonas Formato General|Formato geral de vendas x áreas
Ventas x Forma de Pago|Vendas x forma de pagamento
Ventas Formato Ticket Resumido|Formato de ticket de resumo de vendas
Ventas Formato Ticket x Empleado|Formato de venda Ticket x Employee
Productos Bajo Minimos Formato Ticket|Produtos sob ticket de formato mínimo
Ventas Eliminadas Formato Ticket|Ticket de formato de vendas excluídas
Cierres de Caja Formato Ticket|Bilhete de formato de fechamentos de caixa
Ventas Formato Ticket Detallado|Formato de ticket detalhado de vendas
Subproductos|Subprodutos
Eliminar Datos de Prueba|Excluir dados de teste
Configuracion Empresa|Configuração da empresa
Datos de la Factura|Dados de fatura
Ultimo Nro. Utilizado = |Último Não Usado
Factura Numero|Número da conta
Numeracion de factura|Número da fatura
No Incluidos|Não incluído
Incluidos|Incluído
Impuestos|Impostos
Ancho A5 (14cm)|Largura A5 (14cm)
Ancho 10 cm|Largura 10 cm
Ancho A4 (21cm)|Largura A4 (21cm)
Formato de Factura|Formato de fatura
Logo de la Empresa|Logotipo da empresa
Pagina Web|Pagina web
Direccion|Endereço
Pais|Country
Codigo Postal|Código postal
Detalles de la Empresa|Detalhes da empresa
Recuerde que en la carpeta indicada en la linea superior tiene que existir el archivo nomprog.|Lembre-se que na pasta indicada na linha superior deve existir o arquivo nomprog.
Paso1: Confirme que todos sus equipos esten conectados en red.  Paso2: De todos los equipos que tiene, tiene que seleccionar uno que va a hacer de servidor.  Paso3: El equipo que hara de servidor tiene que tener el disco C compartido y con los permiso|Passo 1: Confirme se todos os seus computadores estão conectados em uma rede. Passo 2: De todo o equipamento que você tem, você tem que selecionar um que vai ser um servidor. Passo 3: A equipe que fará o servidor deve ter o disco compartilhado C e com a permissão
Nota: Localice el equipo que hara de servidor que la base de datos la encontrara en |Nota: Localize o computador que fará com que o servidor o banco de dados o encontre
Conectar con la base de datos|Conecte-se com o banco de dados
Como tiene que poner su equipo  en modo red local (varios equipos)|Como colocar seu computador no modo de rede local (vários computadores)
Conexion con otro Terminal|Conexão com outro terminal
Permisos de Usuario|Permissões do usuário
Seleccione el empleado al que va a configurar permisos|Selecione o empregado para quem você irá definir permissões
Cambio Guardado|Mudança salva
Cambio de Clave|Mudança de Senha
* Maximo 8 caracteres|* Máximo de 8 caracteres
Confirmacion|Confirmação
Nueva|Novo
Antigua|Antígua
Cambiar Contraseña|Alterar senha
Cambios guardados|Mudanças salvas
Aplicar Cambios para este Empleado|Aplicar alterações para este funcionário
Borrar Restricciones|Excluir restrições
Opciones configurables|Opções configuráveis
NO Permite acceso al modulo|NÃO Permite acesso ao módulo
Permite acceso al modulo|Permite acesso ao módulo
Seleccione su pais|Selecione seu país
Nombre del Impuesto (IVA, IGIC, IGV, etc.)|Nome do Imposto (IVA, IGIC, IGV, etc.)
Si en su pais no se aplica esta normativa, NO ACTIVE esta opcion|Se este regulamento não se aplicar no seu país, NÃO ative esta opção
Si ACTIVA esta opcion, en las facturas el num. le aparecera asi: 000- 000-00-0000000X|Se você ativar esta opção, nas faturas o num. vai aparecer assim: 000-000-00-0000000X
En algunos paises la normativa indica que el numero de facturas tiene que ir precedido por una serie de identificadores.|Em alguns países, as regulamentações indicam que o número de faturas deve ser precedido por uma série de identificadores.
INFORMACION SOBRE FACTURAS ESPECIALES|INFORMAÇÃO SOBRE FATURAS ESPECIAIS
Moneda|Moeda
Simbolo Moneda|Símbolo de moeda
Formato Hora:|Formato de hora:
Numero de decimales ( 0,1,2)|Número de decimais (0,1,2)
Identificacion Fiscal (Cif, Nif, Ruc, Rut, Rnc, etc.)|Identificação Fiscal (Cif, Nif, Ruc, Rut, Rnc, etc.)
h=12 Horas (AM o PM)|h = 12 horas (AM ou PM)
h=24 Horas |h = 24 horas
Otra Moneda|Outra moeda
Btc 1 BitCoin = |Btc 1 BitCoin =
€ 1 Euro = |€ 1 Euro =
$ 1 Dolar = |$ 1 dólar =
Hasta 8 decimales|Até 8 casas decimais
Numero de credito fiscal|Número de crédito fiscal
Activar linea propina en preticket|Ativar linha de gorjeta no preticket
Guardar Cambios|Guardar mudanças
Ingrese el concepto|Digite o conceito
Activar concepto Propina / Servicio / Otros|Ativar conceito Derrubada / Serviço / Outro
(Opcion utilizada con frecuencia en algunos paises del caribe y sudameria) / No activar en paises en los que no es obligatorio cobrar propina|(Opção usada com freqüência em alguns países do Caribe e Sudameria) / Não ativar em países onde não é obrigatório cobrar dicas
Secuencia de Apertura|Sequência de Abertura
Para impresoras conexion paralela:|Para impressoras de conexão paralela:
Probar / Guardar|Teste / Salvar
* Click para seleccionar la secuencia de apertura|* Clique para selecionar a seqüência de abertura
Marca de Impresora|Marca de Impressora
Modelo de Impresora|Modelo de impressora
Otras secuencias de apertura|Outras sequências de abertura
Nota: Es posible que la impresora realice el corte sin tener que añadir ninguna secuencia de apertura, en ese caso no hace falta que configure esta opcion|Nota: É possível que a impressora faça o corte sem ter que adicionar nenhuma sequência de abertura, nesse caso você não precisa configurar esta opção
* Click para seleccionar la secuencia de corte|* Clique para selecionar a seqüência de corte
Secuencia de Corte|Seqüência de corte
Otras secuencias de Corte de Papel|Outras seqüências de corte de papel
Configuracion de corte automatico al final del ticket:|Configuração automática de corte no final do ticket:
¿Que son comandos adicionales? Despues de instalar los drivers de la impresora en propiedades de la misma encontramos una pestaña de comandos adicionales / desde aqui marcaremos la opcion de apertura de cajon (Open Draw1 o Open Draw2).|Quais são os comandos adicionais? Depois de instalar os drivers de impressora em propriedades do mesmo encontrar uma aba de comandos adicionais / daqui marcamos a opção de abrir gaveta (Open Draw1 ou Open Draw2).
Apertura estandar para impresoras USB|Abertura padrão para impressoras USB
Para impresoras con comandos adicionales: (serie, paralelo, usb)|Para impressoras com comandos adicionais: (série, paralelo, usb)
Para impresoras salida serie:|Para impressoras de saída serial:
Configuracion de Apertura de Cajon|Configuração de abertura do Cajon
Si conoce que tipo de conexion tiene su impresora de tickets seleccione la que le corresponde en caso contrario pruebe cada uno de ellos hasta confirmar cual es el que abre.|Se você souber que tipo de conexão sua impressora de tickets possui, selecione aquela que corresponde a ela. Caso contrário, tente cada uma delas até confirmar qual delas é aberta.
Ayuda|Ajuda
Configuracion de Cajetin|Configuração Cajetin
Courier New|Courier Novo
Seleccione Tamaño Letra: Cuerpo|Selecione o tamanho da letra: corpo
Seleccione Tamaño Letra: Titulo|Selecione o tamanho da letra: título
Seleccione Tipo Letra|Selecione o tipo de letra
Tipo / Tamaño Letra|Tipo / tamanho carta
Nro. de Decimales que quiero utilizar|No. de decimais que eu quero usar
Mi impresora imprime|Minha impressora imprime
Nro. de caracteres de su impresora|Nº de caracteres da sua impressora
caracteres por linea|caracteres por linha
Poblacion:|População:
Direccion:|Endereço:
Tel:|Tel:
CIF / DNI:|CIF / DNI:
Cliente:|Cliente:
Empleado:|Empregado:
Fact. Simpli:|Fato Simpli:
Codigo Barras|Código de barras
Lineas en blanco al final del ticket = |Linhas em branco no final do ticket =
Escriba aqui su comentario del final de ticket|Escreva seu comentário sobre o ticket aqui
** Gracias por su visita **|** Obrigado por sua visita **
Impuestos Incluidos|Impostos incluidos
Varias lineas para descripcion del producto|Várias linhas para descrição do produto
Añadir codigo de barras en descripcion de producto|Adicionar código de barras na descrição do produto
Otras Opciones|Outras opções
Mostrar P. Unitario|Mostrar P. Unitary
Desglose Impuesto|Repartição de impostos
Total en Letras|Total em Letras
Utilizar SubTotal|Use SubTotal
Cuota|Taxa
Base|Base
Tipo IVA|Tipo de IVA
Entrega|Entrega
P. U.|P. U.
Descripcion|Descrição
Uds|Você
WEB|WEB
Puede cambiar|Pode mudar
CIF|CIF
Nombre Empresa|Razão social
Imagen al Principio|Imagem no começo
Datos de Cabecera|Dados do cabeçalho
Clic para cambiar Imagen|Clique para mudar a imagem
Nro Venta/Pie de Ticket|Sem venda / pé de passagem
Diseño Ticket|Ticket Design
Valor de venta en letras|Valor de venda em letras
Diseño de Ticket|Design do bilhete
Pie de Ticket|Pé de ingresso
Detalles del  Ticket|Detalhes do bilhete
Vista Previa|Vista prévia
Cabecera  Ticket|Ticket Header
Datos del  Cliente|Dados do cliente
Clave:|Senha:
Usuario: Director|Usuário: Diretor
Está a punto de realizar la restauración de sus copias de seguridad de sus bases de datos.  Para ello deberá localizar su copia de seguridad en su disco duro o en su modulo de memoria extraible.  Dicha operación demorará unos segundos, una vez finaliz|Você está prestes a restaurar suas cópias de backup de seus bancos de dados. Para fazer isso, você deve localizar sua cópia de backup em seu disco rígido ou módulo de memória removível. Essa operação levará alguns segundos, uma vez terminada
TPV Hosteleria|POS Terminal Hosteleria
Grafica de Envios|Gráficos de envio
Relacion Emails Enviados|Emails de relacionamento enviados
Envio Promocion|Promoção de envio
Crear Plantillas Reservas|Criar reservas de modelos
Envio Puntual|Envio pontual
Crear Plantillas|Crie modelos
Activar Servicio De Correos|Ativar serviço de postagem
Enviados:|Enviado:
Label6|Label6
Saldo:|Equilíbrio:
Su ID Es|Seu ID é
Servicio Correo|Serviço de correio
Le hemos asignado  20 correos gratis|Nós lhe designamos 20 e-mails gratuitos
Su registro se ha realizado con exito|Seu registro foi concluído com sucesso
Nombre de Usuario|Nome de usuário
Correo de Contacto|E-mail de contato
Incluir Logo|Incluir logotipo
Pie de Correo|Foot Mail
Configuracion Correo|Configuração de Correio
Mensaje Enviado|Mensagem enviada
Enviar|Enviar
Envio Puntual de Correo|Envio de email
toolStrip1|toolStrip1
Mensaje|Mensagem
Remitente|Remetente
Asunto|Assunto
Destinatario|Destinatário
Seleccione el intervalo de fechas|Selecione o período
Chart1|Quadro 1
Grafico|Gráfico
Nueva Plantilla|Novo modelo
Plantillas Promociones|Modelos de promoções
Guardado Correctamente|Salvo corretamente
No|Não
Sí|Sim
¿Desea cargar el diseño anterior?|Você quer carregar o desenho anterior?
Nombre Plantilla|Nome do modelo
Plantilla 3|Template 3
Plantilla 2|Template 2
Plantilla 1|Template 1
Plantilla|Template
<---- Texto que aparece en el cuerpo de la promocion|<---- Texto que aparece no corpo da promoção
<---- Escriba el  texto que desea que aparezca en la parte inferior de la promocion|<---- Escreva o texto que você quer que apareça na parte inferior da promoção
<---- Escriba el titulo o el texto que desea que aparezca en la cabecera de la promocion|<---- Escreva o título ou texto que você quer que apareça no cabeçalho da promoção
Pie de página|Rodapé
Titulo|Título
<---- Haga un click para insertar la imagen|<---- Clique para inserir a imagem
Plantilla Guardada|Modelo salvo
Cuerpo del Mensaje|Corpo da Mensagem
Plantilla Reservas|Reservas de modelos
<---- Texto que se genera automaticamente|<---- Texto gerado automaticamente
<---- Escriba el  texto que desea que aparezca en la parte inferior de la reserva|<---- Escreva o texto que você deseja que apareça na parte inferior da reserva
<---- Escriba el titulo o el texto que desea que aparezca en la cabecera de la reserva|<---- Digite o título ou texto que você deseja que apareça no cabeçalho da reserva
Configurar Email|Configurar email
Mostrar clientes|Mostrar clientes
Filtrar Clientes para Enviar Email|Filtrar clientes para enviar email
Seleccione una opcion|Selecione uma opção
Menor que|Menos que
Mayor que|Maior do que
Consumo|Consumo
Ingrese un codigo postal|Digite um código postal
Todos los clientes|Todos os clientes
Num. Visita|Número de visita
Cumpleaños|Aniversário
Enviando Emails|Envio de e-mails
Cerrar|Fechar
Ctrl+C para copiar los correos de esta lista para hacer un envio desde la aplicacion de correo electronico (gmail, hotmail, etc...) que desee.|Ctrl + C para copiar os e-mails dessa lista para fazer uma remessa do aplicativo de e-mail (gmail, hotmail, etc ...) que você deseja.
Lista de correos seleccionados|Lista de emails selecionados
Enviar Email a Clientes Seleccionados|Enviar email para clientes selecionados
Lista de clientes|Lista de clientes
 Mostrar Todos| Mostrar todos
Emails Seleccionados|Emails selecionados
Marcar Todos|Marcar tudo
Copiar Emails seleccionados  para envio manual|Copiar emails selecionados para entrega manual
 Mostrar solo con Email Valido| Mostrar apenas com email válido
Clientes Seleccionados|Clientes Selecionados
Cantidad de clientes que cumplen las condiciones|Número de clientes que atendem às condições
Importe|Quantidade
Visitas|Visitas
* Si no pone un correo electronico valido no recibirá respuesta|* Se você não colocar um e-mail válido, você não receberá uma resposta
Telefono:|Telefone:
Email: *|Email: *
Ingrese sus datos para poder responderle|Insira suas informações para poder responder
Formule su Consulta|Faça sua pergunta
Aviso de averia|Aviso de avaria
Pregunta o Consulta|Pergunta ou Consulta
Tipo de Consulta|Tipo de consulta
Si tiene alguna Incidencia / Pregunta sobre nuestro programa utilice esta opcion siguiendo los pasos:|Se você tiver alguma Incidência / Pergunta sobre o nosso programa, use esta opção seguindo os passos:
Aviso de Averia / Consulta|Advertência / Consulta
Asistencia y Sugerencias|Assistência e Sugestões
Si no tiene contratado este servicio nuestra empresa no tiene la obligacion de dar ningun tipo de servicio o ser responsable de algun cambio de su sistema informatico.|Se você não tiver este serviço contratado, nossa empresa não terá a obrigação de fornecer qualquer tipo de serviço ou será responsável por qualquer alteração no seu sistema de computador.
Si la compra de este producto ha superado el año y tiene caducado la asistencia / actualizaciones del programa, y tiene un problema recuerde, primero contratar nuestro servicio de asistencia para una solucion adecuada.|Se a compra deste produto excedeu o ano e expirou atualizações assistência / programas, e tem um problema de lembrar, em primeiro lugar recrutar nosso apoio a uma solução adequada.
Cambio de equipo informatico, cambio de disco duro, formateo de disco duro, etc...|Troca de equipamentos de informática, troca de disco rígido, formato de disco rígido, etc ...
4.- Estimado cliente recuerde que sólo podrá recibir las actualizaciones del programa en caso de tener el contrato de mantenimiento al día.|4.- Prezado cliente, lembre-se de que você só pode receber atualizações do programa se tiver o contrato de manutenção atualizado.
3.- Si se produce alguno de estos casos anteriores, antes de realizar ninguna acción,  pongase en contacto con el departamento técnico de SolverMedia comercial@solvermedia.com para que le ayuden a realizar el cambio.|3.- Se algum desses casos anteriores ocorrer, antes de executar qualquer ação, entre em contato com o departamento técnico da SolverMedia comercial@solvermedia.com para ajudá-lo a fazer a alteração.
2.- La empresa SolverMedia no concederá una nueva licencia a aquellos clientes que por problemas ajenos a SolverMedia hallan perdido el registro del programa, esos problemas pueden venir causados por:|2. A empresa não SolverMedia conceder uma nova licença para clientes que SolverMedia problemas são perdidos fora log do programa, esses problemas podem vir causada por:
1.- La empresa SolverMedia no se responsabiliza de la mala manipulación de su registro de licencia así como del numero asignado para su registro.|1.- A empresa SolverMedia não é responsável pela má manipulação do seu registro de licença, bem como o número atribuído para o seu registro.
La contraseña de direccion es: |A senha do endereço é:
Maximo 8 caracteres|Máximo de 8 caracteres
Confirme la contraseña|Confirme a senha
Ingrese la contraseña nueva|Digite a nova senha
Ingrese la contraseña anterior|Digite a senha anterior
Recordatorio de contraseña de direccion|Endereço lembrete de senha
Cambio de contraseña de direccion|Mudança de senha de endereço
Volver a intentar|Tente novamente
Las respuestas introducidas no son correctas|As respostas inseridas não estão corretas
Para poder recordarle la contraseña de direccion es necesario que responda a las siguientes preguntas|Para poder lembrá-lo da senha do endereço, você precisa responder às seguintes perguntas
Año|Year
Mes|Mês
Dia|Dia
Ingrese el segundo apellido de su madre|Digite o segundo sobrenome da sua mãe
Indique su fecha de nacimiento|Indique sua data de nascimento
Si olvida la contraseña que acaba de introducir podra recuperarla respondiendo a las preguntas anteriores.|Se você esquecer a senha que acabou de inserir, poderá recuperá-la respondendo às perguntas anteriores.
La contraseña y las respuestas de recordatorio se han guardado correctamente.|As respostas de senha e lembrete foram salvas corretamente.
Boletas|Cédulas
Facturas|Faturas
codCliente|codClient
Cliente|Cliente
F.Pago|F. Pagamento
** clic en la lista o introduzca el numero de ticket|** clique na lista ou digite o número do bilhete
Ingrese el numero de ticket / factura|Digite o número do bilhete / fatura
Lista de las ultimas ventas|Lista das últimas vendas
Concepto del gasto|Conceito de gastos
Gastos Del Día|Despesas do dia
Ultimos 50 gastos (clic para modificar)|Últimas 50 despesas (clique para modificar)
ESPACIO|ESPAÇO
BORRAR|DELETE
Deja en Caja :|Deixar na caixa:
Cerrar Ventas/Imprimir|Fechar vendas / impressão
Observaciones de caja:|Observações em dinheiro:
Suma/Conteo de caja del turno actual|Contagem de maiúsculas / minúsculas
Seleccione las monedas de su pais|Selecione as moedas do seu país
Cargar monedas de la Zona Euro|Carregar moedas da Zona do Euro
Valor n|Valor n
Terminal = XXX|Terminal = XXX
Total monedas|Moedas totais
Total tarjetas|Total de cartões
Total otras formas de pago|Total de outros métodos de pagamento
Caja Inicial:|Dinheiro Inicial:
Num total de operaciones de este terminal|Número total de operações deste terminal
Num total operaciones otras formas pago|Num total de operações outras formas de pagamento
Num total operaciones tarjeta|Num total de operações com cartão
Num total operaciones contado|Total de transações contadas
Max. 20|Max. 20
Número de tipos de moneda a utilizar:|Número de tipos de moeda a serem usados:
Seleccione las monedas en circulacion de su pais|Selecione as moedas em circulação do seu país
Tipo 20|Digite 20
Nota: Esta opcion solo esta pensado para aquellos clientes que en su pais el valor de sus monedas es diferente al establecido para la zona Euro.|Nota: Esta opção destina-se apenas àqueles clientes que em seu país o valor de suas moedas é diferente daquele estabelecido para a zona do Euro.
Importe a Retirar|Quantidade para retirada
Retiradas|Retirado
TELEF|TELEF
Borrando|Apagar
Hora Reserva|Reserve Time
Nro comensales|Sem comensais
Todos|Todos
Cena|Jantar
Almuerzo|Almoço
Desayuno|Pequeno almoço
MESAS =|TABELAS =
H O R A S|H O R A S
Seleccione Horario|Selecione Horário
*Clic para seleccionar salon|* Clique para selecionar o quarto
R e s e r v a s|R e s e v v s
Diseñar Plantilla reserva|Livro de modelo de design
Nueva Reserva|Nova Reserva
Hora de Reserva|Tempo de reserva
Nro de Comensales|Número de Diners
Teléfono|Telefone
* Click en la columna de telefono para ver la direccion|* Clique na coluna do telefone para ver o endereço
Resultado de la Búsqueda|Resultado da pesquisa
Movil|Mobile
C. Postal|C. Postal
Limpiar|Limpo
DNI|ID
Puerta:|Porta:
Fijo / Movil|Fixo / Móvel
Piso:|Andar:
C. Postal:|C. Postal:
Número:|Número:
Email:|Email:
Modificar Datos|Modificar dados
Nuevo Cliente|Novo cliente
Activar Precios para este terminal de venta|Ativar Preços para este terminal de vendas
Crear nueva o modificar una lista de precios existente|Criar novo ou modificar uma lista de preços existente
Listas de Precios|Listas de Preços
Listas activa en este terminal|Listas ativas neste terminal
Listas de precios no activa|Listas de preços não ativas
La lista de precios que ha seleccionado esta fuera del rango actual|A lista de preços selecionada está fora do intervalo atual
Nombre (click para seleccionar/desactivar)|Nome (clique para selecionar / desativar)
activa|ativo
Fecha Alta|Data alta
Prod. en Lista|Prod. Na lista
Codigo Precio|Código de preço
C. P.|C. P.
Cif / Dni|CIF / Dni
Realizando cambios|Fazendo mudanças
alturapanel|alturapanel
Los mismos pasos 1, 2 para margen comercial o precio de venta.|Os mesmos passos 1, 2 para margem comercial ou preço de venda.
* Clic sobre el impuesto que desea cambiar|* Clique no imposto que você deseja alterar
De:|De:
Cambio el valor de los impuestos|Alterar o valor dos impostos
Deseo cambiar|Eu quero mudar
a:|um:
Nro. de Productos|No. de produtos
2.-Luego seleccione el proveedor o seleccione la opcion todos.|2.-Em seguida, selecione o provedor ou selecione a opção all.
Con redondeo|Com arredondamento
Sin redondeo|Sem arredondamento
Todos los productos|Todos os produtos
Productos del Proveedor|Produtos do Fornecedor
Coste|Custo
Cambio de Coste / Precio|Mudança de Custo / Preço
1.-Si desea aumentar el coste, solo debe ingresar el porcentaje en la caja del mismo.|1.-Se você quiser aumentar o custo, basta digitar a porcentagem na caixa.
Recuerde que este proceso es irreversible. Confirme y  verifique los porcentajes que está aumentando.|Lembre-se que esse processo é irreversível. Confirme e verifique as porcentagens que estão aumentando.
Este proceso automatiza el aumento de precio, margen comercial y coste de los productos.|Este processo automatiza o aumento de preço, margem comercial e custo dos produtos.
Aumento de Precios|Aumento de preço
Nombre Servidor SQL Server|Nome do servidor SQL Server
Utilizar  SQL   Server . . . . . |Use o SQL Server . . . .
UTILIZAR SQL SERVER|USE SERVIDOR SQL
Más Información|Mais informação
Dirigido para aquellas empresas con volumenes de datos altos o muchas interacciones simultaneas soporta varios PC conectados en red sin problemas de concurrencias y trafico de datos. (si este es su caso nuestro programa funciona perfectamente con este ges|Direcionado para as empresas com altos volumes de dados ou muitas interações simultâneas, suporta vários PCs em rede sem problemas de simultaneidade e tráfego de dados. (Se este é o seu caso, o nosso programa funciona perfeitamente com este ges
SQL SERVER|SERVIDOR SQL
Indicado para empresas con volumen de datos bajos 1 o 2 PC en red.|Indicado para empresas com baixo volume de dados 1 ou 2 PCs na rede.
ACCESS|ACESSO
El Tipo de Base De Datos Que Su Negocio Necesita|O tipo de banco de dados que sua empresa precisa
Pasar a la version Basica o Completa|Vá para a versão básica ou completa
Configure los Horarios de su establecimiento|Configurar os horários de seu estabelecimento
Label2|Label2
a |um
El Horario del Establecimiento es:|O cronograma do estabelecimento é:
El Horario de Cocina es:|O horário da cozinha é:
Seleccione el Horario del Establecimiento|Selecione o Horário de Estabelecimento
Seleccione el Horario de Cocina|Selecione o horário da cozinha
4.- Solo le recomendamos que contrate este servicio y utilice esta opcion si solo si su empresa verdaderamente lo necesita, por nuestra experiencia el 90% de los usuarios de Puntos de Venta del sector retail no necesitan tener esta base de datos instalada|4.- Só recomendamos que você contrate este serviço e use esta opção somente se a sua empresa realmente precisar, da nossa experiência 90% dos usuários de Pontos de Venda no setor de varejo não precisam ter esse banco de dados instalado
3.- Tiene que indicarnos los nombre de los usuarios que utilizaran el programa para crear los usuarios en la base de datos. (este servicio incluye 3 usuarios si desea mas usuarios el coste es de 5 Euros por cada uno)|3.- Você deve indicar os nomes dos usuários que usarão o programa para criar os usuários no banco de dados. (este serviço inclui 3 usuários, se você quiser mais usuários, o custo é de 5 euros cada)
2.- Tiene que tener instalado el TeamViewer para que un tecnico pueda conectar a instalar la BD y dejarle el programa funcionando en Sql Server|2.- Você deve ter o TeamViewer instalado para que um técnico possa se conectar para instalar o BD e deixar o programa em execução no Sql Server
1.- Este servicio tiene un coste de 75 Euros + Iva|1.- Este serviço tem um custo de 75 euros + IVA
Si desea utilizar el programa con Sql Server un tecnico de nuestra empresa se lo puede instalar. Pasos que tiene que tomar en cuenta.|Se você quiser usar o programa com o Sql Server, um técnico da nossa empresa poderá instalá-lo. Etapas que você precisa levar em conta
Requisitos Para Usar Sql Server|Requisitos para usar o Sql Server
Numero de Ventas Menores A: |Número de vendas secundárias A:
Seleccione de que terminal quiere obtener la información|Selecione de qual terminal você deseja obter as informações
Servicios|Serviços
Completo|Completo
Total General|Total geral
Total Gastos|Despesas Totais
C. Inicial|C. inicial
Total Retiradas|Retirada total
Totalizado por Forma de Pago|Totalizado pelo formulário de pagamento
Ventas Generales por Dia|Vendas gerais por dia
Esta Forma de Pago es de tipo Tarjeta|Este método de pagamento é tipo de cartão
Nueva Observación|Nova observação
comensal|diner
Observacion|Observação
estado|status
idenvio|idenvio
Seleccione la observacion que desea eliminar del panel de arriba|Selecione a observação que você deseja remover do painel acima
Observaciones a Cocina|Observações para Cozinha
Posicion|Posição
Escriba la nueva observacion|Escreva a nova observação
Eliminar Observación|Excluir observação
Seleccione Mesa Destino|Selecione a tabela de destino
Total Cuenta Origen|Origem total da conta
Seleccione Mesa A Juntar|Selecione a tabela para ingressar
Seleccione Salon Destino|Selecione Salão de Destino
Seleccione Salon|Selecione Salon
Pedidos en Reserva|Pedidos na Reserva
Fecha Seleccionada|Data Selecionada
Total Reservas|Total de Reservas
Reservas Activas|Reservas Ativas
N. Pedido|N. Ordem
Fecha Entrega|Data de entrega
Hora Entrega|Tempo de entrega
Observaciones|Observações
Fecha de Entrega|Data de entrega
Hora de Entrega|Tempo de entrega
Contraseña = |Senha =
Zona|Zona
Venta Original|Venda Original
Total Cuenta Parcial|Conta parcial total
Escriba la clave de gerencia|Digite a chave de gerenciamento